barcodes	celltype_final
AAACGAAAGGTTGTTC	Myeloid.cells
AAAGGTAAGCCTCAAT	T.NK.cells
AAAGTCCAGGTCTGGA	Mesothelial.cells
AAAGTCCCACAGGATG	T.NK.cells
AAAGTCCCAGAACATA	T.NK.cells
AAAGTCCCAGAACCGA	T.NK.cells
AAAGTGATCCCAAGTA	T.NK.cells
AAATGGATCTCGGCTT	Mesothelial.cells
AACAACCTCCCTGTTG	HGSOC
AACAACCTCTGTAACG	Myeloid.cells
AACAAGAGTGGGCTTC	T.NK.cells
AACACACGTACCTAAC	T.NK.cells
AACAGGGAGTGAACAT	Myeloid.cells
AACAGGGCAATCGCGC	Myeloid.cells
AACCATGTCGGTGCAC	T.NK.cells
AACCATGTCTGCTAGA	T.NK.cells
AACCCAAAGGTCCGAA	T.NK.cells
AACCTGAAGCCTAGGA	T.NK.cells
AACCTGAAGTATAGGT	T.NK.cells
AACGTCAAGCCTCTGG	T.NK.cells
AAGAACATCAGACCCG	Myeloid.cells
AAGATAGCAATGTTGC	Myeloid.cells
AAGCGAGGTCGTACAT	Myeloid.cells
AAGCGTTGTACGAGCA	Myeloid.cells
AAGGTAAGTTCGTACA	Myeloid.cells
AAGTACCTCACACCGG	Myeloid.cells
AAGTACCTCTGCTGAA	Myeloid.cells
AAGTTCGGTCTGCCTT	T.NK.cells
AATAGAGAGTCACACT	HGSOC
AATCACGCAAACGAGC	T.NK.cells
AATGACCGTTGGAGAC	T.NK.cells
AATGCCAGTTCTAACG	T.NK.cells
AATGCCATCTACCACC	T.NK.cells
AATGGCTTCGGAGTAG	T.NK.cells
AATTTCCAGGGCTTCC	Myeloid.cells
ACAAAGAGTACTGCCG	T.NK.cells
ACACGCGCACTTGAGT	B.cells
ACAGCCGAGTAAATGC	Myeloid.cells
ACATCCCCACGGCACT	HGSOC
ACATTTCTCTCGAACA	Myeloid.cells
ACCCTCAGTAGTGGCA	Myeloid.cells
ACCTACCGTGCAACAG	Myeloid.cells
ACCTACCGTGGGTTGA	B.cells
ACCTGAAGTCAATCTG	T.NK.cells
ACGCACGTCCTCACCA	Mesothelial.cells
ACGGTCGAGGGATCGT	B.cells
ACGGTCGCACTCACTC	Myeloid.cells
ACGGTTAAGGTACTGG	Myeloid.cells
ACGTAACAGTGGTGGT	HGSOC
ACGTAACTCATTTGGG	T.NK.cells
ACGTAGTTCACTAGCA	Mesothelial.cells
ACGTCCTAGTCTCTGA	Myeloid.cells
ACGTTCCTCACCTACC	B.cells
ACTATGGTCTTTCTAG	T.NK.cells
ACTGCAAGTACGGATG	Myeloid.cells
ACTGTCCCAGGCATGA	T.NK.cells
ACTGTCCGTCACTCGG	Myeloid.cells
ACTGTGATCTTGTGCC	Fibroblasts
ACTTAGGGTAACAAGT	T.NK.cells
ACTTTGTTCGATACAC	Mesothelial.cells
AGAACAAAGACTCAAA	Mesothelial.cells
AGAACAAGTTGCCATA	B.cells
AGACAAACATACTTTC	T.NK.cells
AGACAAATCCCGGTAG	B.cells
AGACAGGCATCCGATA	Mesothelial.cells
AGACCCGGTCCTCAGG	T.NK.cells
AGACTCAAGCTGCCTG	T.NK.cells
AGACTCAAGGTGATCG	T.NK.cells
AGAGAGCTCGAGGCAA	Mesothelial.cells
AGAGCCCTCGAGTGAG	B.cells
AGATAGAAGGTAACTA	T.NK.cells
AGATGAACATTGCTTT	T.NK.cells
AGATGAATCTTAATCC	T.NK.cells
AGATGCTAGCGCTGAA	Myeloid.cells
AGCGATTCACCTTCGT	T.NK.cells
AGCGTATAGTTTCGAC	T.NK.cells
AGGAATACACGTTCGG	Myeloid.cells
AGGAGGTAGCGATGCA	Mesothelial.cells
AGGAGGTCACTACCCT	T.NK.cells
AGGCATTCAGACCTAT	T.NK.cells
AGGCATTGTTAGGCCC	T.NK.cells
AGGCTGCGTGCCGAAA	HGSOC
AGGGAGTAGGTGCTAG	Myeloid.cells
AGGGCCTAGCAGTACG	T.NK.cells
AGGGCTCAGACCTTTG	T.NK.cells
AGGTCTACAGAGGCTA	Myeloid.cells
AGGTTACAGATACAGT	Myeloid.cells
AGGTTACGTCTTGAAC	T.NK.cells
AGGTTGTCAATTCACG	Fibroblasts
AGTACTGAGTGACACG	Mesothelial.cells
AGTACTGGTGATTGGG	T.NK.cells
AGTAGTCAGCGGCTCT	T.NK.cells
AGTCATGAGCTGTCCG	T.NK.cells
AGTCATGCACATACGT	T.NK.cells
AGTGACTAGTATGGCG	B.cells
AGTGACTAGTCCCAGC	T.NK.cells
AGTGATCAGGTTGTTC	HGSOC
AGTGCCGAGCGATGAC	T.NK.cells
AGTGCCGAGCGCCATC	T.NK.cells
AGTGCCGCAAATGATG	B.cells
AGTTCGAAGTCACTAC	T.NK.cells
AGTTCGAGTCGGTGTC	Myeloid.cells
ATACCGAAGGGTAGCT	T.NK.cells
ATACCGATCCCTCTTT	Myeloid.cells
ATAGAGACAATACGAA	Mesothelial.cells
ATAGAGATCATCGCTC	T.NK.cells
ATAGAGATCTGTGCGG	T.NK.cells
ATAGGCTTCTATTCGT	T.NK.cells
ATCACGAGTTGGAGGT	T.NK.cells
ATCAGGTAGAAGTCCG	T.NK.cells
ATCATTCAGGTCGAGT	Fibroblasts
ATCATTCCAACTCCAA	Myeloid.cells
ATCCATTAGACGAAGA	Fibroblasts
ATCCATTGTGAGCGAT	B.cells
ATCCCTGGTCTCAAGT	Myeloid.cells
ATCGCCTCAGACTCTA	Myeloid.cells
ATCGGATCAGTAGAGC	Fibroblasts
ATCGTAGAGGTTACAA	T.NK.cells
ATCGTCCGTTATCCAG	T.NK.cells
ATCTCTAGTTGCATGT	Mesothelial.cells
ATGACCAGTTTGAACC	Mesothelial.cells
ATGAGGGCAGCCCACA	T.NK.cells
ATGATCGCAGCCTTCT	Myeloid.cells
ATGATCGGTTCTCCCA	T.NK.cells
ATGATCGTCTCTCTTC	T.NK.cells
ATGCATGAGGTAGCAC	Myeloid.cells
ATGCGATCACTCACTC	B.cells
ATGCGATCATGGTACT	Myeloid.cells
ATGCGATGTGTCCCTT	B.cells
ATGGAGGCAGCGTTGC	T.NK.cells
ATGTCTTAGCACCGTC	Myeloid.cells
ATGTCTTAGTCCTACA	Myeloid.cells
ATGTCTTCATCAGCAT	T.NK.cells
ATGTCTTGTATCGTTG	T.NK.cells
ATTACCTCAGCACAGA	T.NK.cells
ATTACTCTCAAGGTGG	Myeloid.cells
ATTATCCCACCAAATC	T.NK.cells
ATTATCCCATCTCCCA	Fibroblasts
ATTCCATGTTGAGAGC	Myeloid.cells
ATTCCTACAACGTAAA	Mesothelial.cells
ATTCCTATCTCTGGTC	T.NK.cells
ATTCTTGAGTATGACA	Myeloid.cells
CAAAGAAAGAAATTCG	Myeloid.cells
CAACAACCACCCTATC	T.NK.cells
CAACAACGTAGTGATA	T.NK.cells
CAACAACGTTAGGCCC	B.cells
CAACCTCCAAGGTCTT	T.NK.cells
CAAGCTAAGTGCCGAA	T.NK.cells
CAAGCTATCCTTCAGC	T.NK.cells
CAAGGGATCCGTACGG	T.NK.cells
CAATTTCCAAGGAGTC	Mesothelial.cells
CAATTTCCATCGGTTA	Myeloid.cells
CACAACAGTCTTTCAT	Myeloid.cells
CACAGATAGTCAGCGA	T.NK.cells
CACAGGCCAGTAACCT	T.NK.cells
CACATGAGTCATATGC	T.NK.cells
CACATGATCCTTATGT	HGSOC
CACCGTTGTACGTGAG	T.NK.cells
CACGGGTGTAGCGCTC	T.NK.cells
CACGTGGAGTGTTCAC	Fibroblasts
CACTAAGCATTGTGCA	T.NK.cells
CACTGAAAGTCAAGCG	Myeloid.cells
CACTGGGGTTATTCTC	Myeloid.cells
CAGATACGTGCGAGTA	T.NK.cells
CAGATCAAGCGCTGCT	T.NK.cells
CAGATTGAGTATGAAC	Myeloid.cells
CAGCAGCCATCGTTCC	Myeloid.cells
CAGCGTGGTAGCCCTG	Fibroblasts
CAGGTATCACAATGTC	Myeloid.cells
CAGTTCCAGGGTCACA	Myeloid.cells
CATACAGGTGGAACAC	T.NK.cells
CATACCCAGTAGAATC	B.cells
CATACTTTCGGCCAAC	T.NK.cells
CATCAAGAGGGCAGAG	T.NK.cells
CATCCACAGTGAGCCA	T.NK.cells
CATCCACCAAGCTACT	Myeloid.cells
CATCCCATCGTCACCT	Myeloid.cells
CATCCCATCTTACCGC	T.NK.cells
CATCCGTCATCCCGTT	T.NK.cells
CATCCGTTCCTATGGA	T.NK.cells
CATCGGGAGAAGAACG	T.NK.cells
CATCGGGTCGCCTTGT	T.NK.cells
CATGAGTAGTTTGCTG	T.NK.cells
CATGCAAGTAGCTAAA	T.NK.cells
CATGCCTCAGCTATTG	T.NK.cells
CATGCCTGTCGAGCAA	Myeloid.cells
CATGCTCTCAATCCGA	B.cells
CATGGATCACAGCTGC	Fibroblasts
CATGGATGTTCGGCTG	Myeloid.cells
CATGGTAAGTCATCGT	T.NK.cells
CATGGTACACCATATG	T.NK.cells
CATTCTAAGCCTTGAT	Myeloid.cells
CATTCTAGTCCTGGGT	T.NK.cells
CATTGCCCACGTTGGC	Fibroblasts
CATTTCAGTGGATCGA	Fibroblasts
CCAAGCGTCCACCCTA	T.NK.cells
CCAATTTCAGAGATGC	T.NK.cells
CCACGAGAGTCTTGGT	HGSOC
CCACGAGTCGGTCGAC	Fibroblasts
CCATAAGAGGCCCACT	T.NK.cells
CCCGGAAAGATGCGAC	Myeloid.cells
CCCGGAAGTGGTAACG	T.NK.cells
CCCTAACAGGTAATCA	T.NK.cells
CCCTAACCAATAACGA	T.NK.cells
CCCTAACCAGACCTAT	T.NK.cells
CCCTCAATCTCGACCT	T.NK.cells
CCCTCTCCAAAGCGTG	T.NK.cells
CCCTCTCCATACACCA	Myeloid.cells
CCCTGATGTGATTCTG	Myeloid.cells
CCGGACAGTTGGGACA	T.NK.cells
CCGGACATCCCGAATA	T.NK.cells
CCGGTAGTCCGCATAA	Myeloid.cells
CCGGTGAGTCTTTATC	T.NK.cells
CCGTAGGCACCAACAT	T.NK.cells
CCGTGAGAGTACGAGC	T.NK.cells
CCGTTCACAGACCCGT	Myeloid.cells
CCGTTCATCGGAACTT	Myeloid.cells
CCTACGTTCTTTCGAT	Myeloid.cells
CCTCACACAATGTTGC	T.NK.cells
CCTCACATCTGAATGC	Mesothelial.cells
CCTCCAACACACCTAA	T.NK.cells
CCTCCAAGTTCCAGGC	Mesothelial.cells
CCTGCATGTAGGCTCC	T.NK.cells
CCTGTTGCAATCGCGC	Fibroblasts
CCTTGTGTCTCAATCT	B.cells
CCTTTGGTCTCGGGAC	T.NK.cells
CGAAGGAGTGCCTTCT	Myeloid.cells
CGAAGTTCATCCGGCA	Myeloid.cells
CGAATTGCATGAAAGT	T.NK.cells
CGACAGCAGACCAACG	Mesothelial.cells
CGATGGCTCTTAGGAC	Myeloid.cells
CGCAGGTGTTCCTACC	Myeloid.cells
CGCAGGTTCAATGTCG	T.NK.cells
CGCATAACAGCTATTG	T.NK.cells
CGCATAATCTGCCTCA	Myeloid.cells
CGCATGGGTACGTTCA	Myeloid.cells
CGCATGGTCAATCCGA	T.NK.cells
CGCCAGATCGCTAAAC	T.NK.cells
CGGAACCAGATTACCC	Myeloid.cells
CGGAACCTCCCAGCGA	Fibroblasts
CGGACACGTAAGGCCA	Myeloid.cells
CGGGCATCAGGTGGAT	HGSOC
CGTAAGTAGGTAAAGG	Myeloid.cells
CGTAGTAAGAGGCTGT	T.NK.cells
CGTAGTAAGGCCACCT	Myeloid.cells
CGTAGTACACTCAAGT	T.NK.cells
CGTCAAAGTGCTCTCT	B.cells
CGTCAAAGTTAGGGTG	T.NK.cells
CGTGAATCACTGGCGT	B.cells
CGTTAGAAGATGACAT	Mesothelial.cells
CGTTAGAGTAACTAAG	T.NK.cells
CTAACCCAGTCGAAGC	Fibroblasts
CTACAGAGTTGCGGCT	Myeloid.cells
CTACATTGTACGCGTC	Fibroblasts
CTACCCATCCTTACCG	Myeloid.cells
CTACCTGTCAAGAGGC	Myeloid.cells
CTACTATGTAAGCGGT	T.NK.cells
CTACTATGTTCATCGA	T.NK.cells
CTCAAGAAGAATAGTC	Myeloid.cells
CTCAATTTCGACACCG	HGSOC
CTCACTGGTCCTATAG	T.NK.cells
CTCAGTCAGTTGGAAT	T.NK.cells
CTCAGTCTCGCGTGAC	T.NK.cells
CTCATCGGTGTTCATG	T.NK.cells
CTCATGCAGCAGCGAT	HGSOC
CTCATGCGTTAAACCC	Fibroblasts
CTCATTACAGTAGGAC	T.NK.cells
CTCCACACAGTCTGGC	B.cells
CTCGAGGGTGTCCACG	T.NK.cells
CTCTCAGCAAGACTGG	T.NK.cells
CTCTGGTGTGGACTAG	Myeloid.cells
CTGAGCGGTCAGTCTA	Mesothelial.cells
CTGCAGGTCGAGCTGC	T.NK.cells
CTGCAGGTCTTCCCAG	Fibroblasts
CTGCGAGAGTGATAGT	Mesothelial.cells
CTGGACGAGTAAATGC	Myeloid.cells
CTGGTCTTCATGCATG	T.NK.cells
CTGTAGAAGTTCCATG	T.NK.cells
CTGTATTAGCACTAAA	HGSOC
CTGTGAATCTGATTCT	T.NK.cells
CTTAGGAAGATGGTCG	T.NK.cells
CTTAGGATCACGTAGT	Myeloid.cells
CTTCAATCACCAAAGG	T.NK.cells
CTTCAATGTATTTCTC	Myeloid.cells
CTTCAATTCGAGAGAC	T.NK.cells
CTTCCGACAGCGTTGC	HGSOC
CTTCCGAGTACTCGTA	Myeloid.cells
CTTCCGATCGAGTACT	T.NK.cells
CTTCCTTGTATGGAGC	Fibroblasts
CTTCTCTAGTCATGAA	T.NK.cells
CTTCTCTCAAGTGGGT	T.NK.cells
CTTGAGAAGATGCCGA	T.NK.cells
CTTGAGATCTAGCAAC	HGSOC
CTTTCAAAGGAGCTGT	T.NK.cells
GAAACCTAGACCCTTA	T.NK.cells
GAAACCTAGGTCGACA	Myeloid.cells
GAACTGTGTCGACTGC	Myeloid.cells
GAAGAATCAGAATTCC	T.NK.cells
GAAGAATTCTAGCCTC	Myeloid.cells
GAAGCGATCATTTCGT	HGSOC
GAAGCGATCGTGAGAG	T.NK.cells
GAAGTAAAGAACTCCT	B.cells
GAATAGAGTTGGCCTG	T.NK.cells
GAATAGATCCTATGGA	T.NK.cells
GAATCACAGACACACG	Mesothelial.cells
GAATCACAGTCTACCA	Fibroblasts
GACACGCAGACGCAGT	T.NK.cells
GACGCTGCAAGCTACT	T.NK.cells
GACGCTGTCTAGACAC	Myeloid.cells
GACTATGAGTAGCAAT	T.NK.cells
GACTCAACACGACGTC	Mesothelial.cells
GACTTCCAGTGCACCC	T.NK.cells
GAGAAATCAAAGCTCT	Fibroblasts
GAGAAATCACGTACTA	B.cells
GAGAAATTCATCGCTC	T.NK.cells
GAGACTTTCTGGTTGA	T.NK.cells
GAGCCTGCAAGAGGCT	T.NK.cells
GAGGGTAGTGGCTTAT	Myeloid.cells
GAGTCTACATGTGTCA	Mesothelial.cells
GAGTTTGGTGCCTACG	Myeloid.cells
GATAGAACAACTTGCA	T.NK.cells
GATAGCTAGAGAGTTT	Myeloid.cells
GATCGTAAGGTAACTA	Fibroblasts
GATCGTATCCATTGCC	Endothelial.cells
GATGAGGTCAAGTGGG	Fibroblasts
GATGATCCAGCAGTCC	T.NK.cells
GATGCTAAGCCGCTTG	T.NK.cells
GATGCTATCAGCCTCT	Myeloid.cells
GATGGAGAGCAACTTC	T.NK.cells
GATGGAGAGCTCATAC	Mesothelial.cells
GATTCTTGTCTGTCAA	T.NK.cells
GCAACCGCACGGCACT	T.NK.cells
GCACGTGAGAGTTGAT	Myeloid.cells
GCACGTGGTTACACTG	B.cells
GCAGCCACATGAATAG	T.NK.cells
GCAGCTGCAGACATCT	Myeloid.cells
GCAGGCTCACCTGCGA	Myeloid.cells
GCAGGCTGTACGGCAA	Myeloid.cells
GCATGATCACAAATCC	HGSOC
GCATGATTCAATCTCT	Myeloid.cells
GCCAACGCATTAAGCC	Myeloid.cells
GCCAACGGTACCTAAC	T.NK.cells
GCCAGGTAGACATAGT	T.NK.cells
GCCAGTGGTGGGTCAA	Fibroblasts
GCCAGTGGTTCCGCGA	T.NK.cells
GCCCAGACAGTTACCA	T.NK.cells
GCCCAGACATGGATCT	Myeloid.cells
GCCCAGATCGCCAATA	T.NK.cells
GCCCGAAAGGCTAAAT	T.NK.cells
GCCTGTTTCTCGTGGG	Fibroblasts
GCGAGAAGTTCCGCAG	Myeloid.cells
GCGAGAATCTGGCCGA	T.NK.cells
GCGTTTCGTGAGGATC	T.NK.cells
GCTACAAAGAATTGTG	Fibroblasts
GCTGAATGTGGGCTTC	T.NK.cells
GCTGGGTAGCACGATG	B.cells
GCTGGGTGTATTGGCT	T.NK.cells
GCTGGGTTCACAGTGT	Fibroblasts
GCTTCACGTGAGAACC	HGSOC
GCTTCACTCCTCCACA	T.NK.cells
GCTTGGGAGAACCCGA	Myeloid.cells
GCTTGGGTCGGACCAC	B.cells
GGAACCCAGACTCCGC	Myeloid.cells
GGAAGTGTCATGCCAA	T.NK.cells
GGAATGGTCGAGCCAC	Fibroblasts
GGACGTCTCGCTAATG	Myeloid.cells
GGAGAACTCGTCAGAT	Myeloid.cells
GGAGATGCATAGGTAA	Myeloid.cells
GGAGGTAGTCGCTGCA	Fibroblasts
GGAGGTAGTTGCATCA	Mesothelial.cells
GGATGTTCATAGAAAC	T.NK.cells
GGCACGTCAATGTGGG	T.NK.cells
GGCAGTCTCGACACTA	Fibroblasts
GGCTGTGTCTGGACCG	Myeloid.cells
GGCTTTCAGTCACTCA	Fibroblasts
GGGAAGTGTCTACTGA	T.NK.cells
GGGACAACATTAAAGG	T.NK.cells
GGGACAATCTAACGGT	Mesothelial.cells
GGGAGTAGTTGGGTAG	Myeloid.cells
GGGAGTATCCTGCTAC	Myeloid.cells
GGGCCATAGATGACCG	T.NK.cells
GGGCTCAAGCGCACAA	T.NK.cells
GGGTCTGTCACTGGGC	T.NK.cells
GGGTGTCTCGCCTTTG	T.NK.cells
GGTCTGGAGACGGAAA	T.NK.cells
GGTGATTAGACTGAGC	Mesothelial.cells
GGTGATTCAGAGGCAT	T.NK.cells
GGTTGTAAGACTACGG	T.NK.cells
GGTTGTATCACGGAGA	T.NK.cells
GTAACACGTGACACAG	Myeloid.cells
GTAACCAAGACCCGCT	HGSOC
GTAACCAAGCAAACAT	T.NK.cells
GTAAGTCCATAGGTAA	HGSOC
GTAAGTCTCCTCTCTT	Endothelial.cells
GTAATCGCAGAAGTGC	Myeloid.cells
GTAATGCAGTATCCTG	Mesothelial.cells
GTAATGCTCGCCTTTG	Mesothelial.cells
GTACAACCAACAGTGG	B.cells
GTACAGTAGAAAGCGA	B.cells
GTAGAAAAGTTATGGA	T.NK.cells
GTAGAAACACCCGTAG	T.NK.cells
GTAGATCGTGTTAAAG	T.NK.cells
GTAGATCGTTTCACTT	T.NK.cells
GTAGCTAAGGAGAATG	Mesothelial.cells
GTAGCTATCACTTATC	HGSOC
GTAGGAGGTGGCTGCT	B.cells
GTCAAACGTCGCCACA	T.NK.cells
GTCAAACTCAGTCCGG	T.NK.cells
GTCAAACTCAGTGCGC	T.NK.cells
GTCACGGAGGACACTG	T.NK.cells
GTCAGCGCAATCGCCG	T.NK.cells
GTCATGAGTTTCAGAC	Fibroblasts
GTCATGATCAACGCTA	Fibroblasts
GTCCCATCAGCTAACT	T.NK.cells
GTCCCATGTTCGTACA	HGSOC
GTCCTCAAGGTCCAGA	Myeloid.cells
GTCCTCAGTTGCCTAA	T.NK.cells
GTCCTCAGTTGGCTAT	T.NK.cells
GTCTAGACAAGTCGTT	T.NK.cells
GTCTGTCCAACTTGGT	T.NK.cells
GTCTTTATCGACGCGT	Myeloid.cells
GTGACGCAGATTAGCA	T.NK.cells
GTGACGCTCTCTTAAC	B.cells
GTGATGTGTTCTCTCG	T.NK.cells
GTGCACGAGCCACAAG	HGSOC
GTGCAGCGTCGCTCGA	T.NK.cells
GTGCTGGTCGTCCATC	T.NK.cells
GTGGAAGTCTCGACCT	Myeloid.cells
GTGGAGATCGTTCGCT	Myeloid.cells
GTGGGAACAGCTTTCC	Myeloid.cells
GTGGTTAGTGAATGAT	Mesothelial.cells
GTGTGATCACATACTG	Myeloid.cells
GTGTGGCCACATAACC	Myeloid.cells
GTGTTCCCAGCTTCGG	Myeloid.cells
GTGTTCCTCCCAGCGA	Myeloid.cells
GTTACAGCACTGCGTG	T.NK.cells
GTTACAGGTCTAGGTT	HGSOC
GTTAGACGTATCAGCT	Mesothelial.cells
GTTAGTGCATCGAACT	Myeloid.cells
GTTCATTAGATTACCC	Fibroblasts
GTTCATTAGCTCTGTA	T.NK.cells
GTTCTATGTCTTTCAT	T.NK.cells
GTTGCGGAGGTACTGG	T.NK.cells
GTTGCGGCACCTCGTT	T.NK.cells
GTTGTAGGTATGGGAC	T.NK.cells
GTTTGGAAGCATGATA	Myeloid.cells
TAACACGCACCAGGTC	T.NK.cells
TAACACGTCGGTCTAA	Mesothelial.cells
TAACGACGTGGTGATG	T.NK.cells
TAACTTCGTCTGATCA	Myeloid.cells
TAAGCGTCAGCTGTCG	T.NK.cells
TAATCTCGTAACATAG	T.NK.cells
TAATCTCGTAAGCGGT	Myeloid.cells
TAATCTCTCAGGAAAT	Myeloid.cells
TAATTCCCATTGCCTC	T.NK.cells
TACAACGAGCGAGGAG	T.NK.cells
TACACCCGTACAGTTC	Fibroblasts
TACAGGTAGCATTGTC	T.NK.cells
TACATTCCACACCAGC	B.cells
TACCCACAGGTGCCTC	Myeloid.cells
TACCCACGTAACCAGG	T.NK.cells
TACCCACGTGAGAACC	Myeloid.cells
TACCGGGCACAATCTG	T.NK.cells
TACCGGGTCCTACTGC	Myeloid.cells
TACCTGCCAAGTCCCG	T.NK.cells
TACGGGCCAACACAGG	Myeloid.cells
TACGGTACATCCTAAG	HGSOC
TACTGCCGTTGCACGC	T.NK.cells
TACTTACGTTAGAAGT	T.NK.cells
TACTTCACAATCCTTT	T.NK.cells
TAGACTGGTAGATTGA	T.NK.cells
TAGATCGCAGTTGTTG	HGSOC
TAGCACATCTACACTT	T.NK.cells
TAGGGTTAGAAGGATG	Fibroblasts
TAGGTACCATGTCAGT	Mesothelial.cells
TAGGTTGGTTATGACC	Myeloid.cells
TATACCTAGGCAGCTA	Myeloid.cells
TATACCTAGGGTGGGA	T.NK.cells
TATACCTAGGTCATCT	T.NK.cells
TATCAGGAGAAACTCA	Mesothelial.cells
TATCCTACAGAGGCTA	B.cells
TATCGCCGTTACACTG	Myeloid.cells
TATCTTGCATGGCCCA	HGSOC
TATTTCGAGGTAGCAC	T.NK.cells
TCAAGACCACATTCTT	Myeloid.cells
TCAAGACGTACCGTGC	Myeloid.cells
TCAAGTGAGCCGTAAG	Mesothelial.cells
TCAATTCTCGATACAC	T.NK.cells
TCACAAGAGCCTCTTC	T.NK.cells
TCACAAGGTAGCTGAG	T.NK.cells
TCACAAGTCACACCGG	Mesothelial.cells
TCACAAGTCGATTCCC	HGSOC
TCACGCTAGCGATCGA	B.cells
TCACGCTCACGGAAGT	B.cells
TCACTCGCATTGTCGA	Mesothelial.cells
TCAGCAACAGCCGTCA	T.NK.cells
TCAGCAAGTGCCTTTC	T.NK.cells
TCAGCCTGTCTCAAGT	Myeloid.cells
TCAGGTAAGTTTCTTC	Fibroblasts
TCAGTGAAGATTGATG	Myeloid.cells
TCAGTGAAGCCAGAGT	Fibroblasts
TCAGTGATCACATACG	T.NK.cells
TCATATCAGGGATCTG	T.NK.cells
TCATCATCAGCCTTCT	HGSOC
TCATGAGGTTGGGTTT	T.NK.cells
TCATGTTCAGCAGTCC	T.NK.cells
TCATGTTCAGGGAATC	Myeloid.cells
TCATTACGTCACCACG	HGSOC
TCATTCAAGTGCTAGG	T.NK.cells
TCATTCACATCGTGCG	T.NK.cells
TCATTTGAGGTCGTAG	T.NK.cells
TCATTTGGTGTGTTTG	HGSOC
TCCACCAAGGTTAGTA	Myeloid.cells
TCCACGTTCTCCATAT	T.NK.cells
TCCATCGAGGTCCCGT	Myeloid.cells
TCCATGCTCGCAGTGC	Myeloid.cells
TCCCACAAGTCTCCTC	B.cells
TCCCATGAGGCGACAT	Mesothelial.cells
TCCGTGTTCAGAGTTC	B.cells
TCGAAGTCAGCGTATT	T.NK.cells
TCGATTTAGGCTAACG	T.NK.cells
TCGCACTAGGCTGAAC	T.NK.cells
TCGCAGGCAATGCAGG	T.NK.cells
TCGCAGGGTTGCCGAC	Fibroblasts
TCGGATACATCCGCGA	B.cells
TCGGGCAGTTAGAAAC	T.NK.cells
TCGGTCTGTACTTGTG	Myeloid.cells
TCGTGCTCACCATTCC	T.NK.cells
TCGTGCTGTACACGCC	Fibroblasts
TCTAACTAGCCAAGCA	T.NK.cells
TCTAACTCATCTGCGG	T.NK.cells
TCTAACTGTATGCGTT	T.NK.cells
TCTACATTCATTGTTC	T.NK.cells
TCTACATTCCGTTGAA	T.NK.cells
TCTACATTCTCTTAAC	Myeloid.cells
TCTCACGTCATGTCTT	Myeloid.cells
TCTCAGCGTACGGTTT	T.NK.cells
TCTCTGGAGATCGCTT	T.NK.cells
TCTCTGGTCATCCTGC	HGSOC
TCTGCCAGTAGGAAAG	B.cells
TCTGGCTCAACTGCCG	Fibroblasts
TCTGTCGCATCATTTC	T.NK.cells
TCTGTCGTCAGCTTCC	B.cells
TGAACGTAGCCAGAGT	Myeloid.cells
TGAACGTCAGTCCGTG	Myeloid.cells
TGAATGCAGATAACGT	Fibroblasts
TGAATGCAGGTCACAG	T.NK.cells
TGACAGTAGAGTTGTA	T.NK.cells
TGACCCTAGATGGCGT	HGSOC
TGACTCCCATCCGAAT	Myeloid.cells
TGAGCATGTATTTCCT	T.NK.cells
TGAGCGCAGGTGCCAA	Mesothelial.cells
TGAGCGCTCAGCATTG	T.NK.cells
TGAGCGCTCCCTCGAT	Myeloid.cells
TGAGGTTAGTTGCTGT	T.NK.cells
TGAGGTTGTCAGCTTA	T.NK.cells
TGAGTCACATCACCAA	Myeloid.cells
TGATCAGCATCCGATA	B.cells
TGATGGTCAACACAAA	T.NK.cells
TGATGGTGTTACCCAA	Myeloid.cells
TGATTTCAGACTGAGC	T.NK.cells
TGATTTCTCAGCTCTC	Mesothelial.cells
TGCAGATAGCTGGCTC	T.NK.cells
TGCAGGCTCGTCGCTT	HGSOC
TGCAGTATCTCCCAAC	T.NK.cells
TGCATGAAGAAACTCA	T.NK.cells
TGCATGATCACCCATC	Myeloid.cells
TGCCGAGCAAGTCATC	B.cells
TGCGACGTCCATAGGT	Myeloid.cells
TGCGGGTAGGGTAGCT	T.NK.cells
TGCTCGTTCTGCACCT	T.NK.cells
TGCTGAAGTGTCCCTT	HGSOC
TGCTTCGTCACCATAG	Mesothelial.cells
TGGATCAAGCAAACAT	T.NK.cells
TGGATGTCACCGTCGA	T.NK.cells
TGGGAGAAGGTTGGAC	T.NK.cells
TGGGATTAGCTTTGTG	T.NK.cells
TGGGCGTAGCACCTGC	Myeloid.cells
TGGGTTAGTCTGTGTA	B.cells
TGGTGATGTTTGGGAG	Myeloid.cells
TGGTGATTCCGAGGCT	T.NK.cells
TGTCCACGTTCTTGTT	B.cells
TGTCCTGCAACCGCTG	Myeloid.cells
TGTGAGTGTCCTTTGC	Myeloid.cells
TGTGCGGGTGGTGATG	Myeloid.cells
TGTGGCGGTCGAGCAA	T.NK.cells
TGTTACTTCGAATGCT	T.NK.cells
TGTTACTTCGGACTTA	T.NK.cells
TGTTCTAAGCTCCACG	Fibroblasts
TGTTGAGTCTGCCTCA	Myeloid.cells
TTAATCCAGCGAATGC	Mesothelial.cells
TTAATCCGTCCTGAAT	T.NK.cells
TTAATCCGTTGTCAGT	B.cells
TTACAGGCAATACGCT	Myeloid.cells
TTACCATCACAGGATG	Myeloid.cells
TTACCATCAGACTCTA	Myeloid.cells
TTACCATCAGGAACCA	T.NK.cells
TTACCGCAGGACAGCT	Myeloid.cells
TTACGCCCACGACGTC	B.cells
TTACGCCCAGAGAATT	Myeloid.cells
TTACGCCTCCACCCTA	Myeloid.cells
TTACTGTCAGCTACTA	T.NK.cells
TTACTGTTCGGCTGTG	T.NK.cells
TTAGGCAGTATCTTCT	Myeloid.cells
TTAGGGTAGTAAAGCT	Myeloid.cells
TTAGTCTCACAGCCAC	T.NK.cells
TTCAATCAGTGGCGAT	HGSOC
TTCAATCGTCTGCGCA	T.NK.cells
TTCCAATGTCACAGTT	T.NK.cells
TTCCACGAGCAACAGC	T.NK.cells
TTCCGTGGTTCGGTTA	T.NK.cells
TTCCTCTAGGGCGAGA	Myeloid.cells
TTCCTCTCAAAGCAAT	T.NK.cells
TTCCTTCCACTAGGTT	Fibroblasts
TTCGCTGGTCAATCTG	Myeloid.cells
TTCGCTGGTCTAACTG	T.NK.cells
TTCTAACGTGCAATGG	HGSOC
TTCTCTCCAAAGGAGA	Myeloid.cells
TTCTCTCTCTTCGTGC	T.NK.cells
TTCTGTAGTCAGTCCG	B.cells
TTCTTGACAAGAATGT	HGSOC
TTCTTGACAGATTCGT	T.NK.cells
TTCTTGATCCACAGGC	T.NK.cells
TTGAACGAGCCGTTAT	T.NK.cells
TTGAACGCAGATTTCG	Myeloid.cells
TTGAACGTCAGAATAG	Myeloid.cells
TTGACCCTCTCTATAC	T.NK.cells
TTGAGTGTCAGCGCGT	Myeloid.cells
TTGATGGAGGTGCTAG	Mesothelial.cells
TTGCCTGCATACTGTG	Fibroblasts
TTGCGTCTCTTCGATT	T.NK.cells
TTGGATGTCACTCGAA	Myeloid.cells
TTGTGGAGTGAGTTTC	Myeloid.cells
TTGTTCAGTGGATCAG	T.NK.cells
TTTACCAAGAGCCATG	T.NK.cells
TTTACCAGTATGGTTC	Myeloid.cells
TTTACGTGTATCCCAA	HGSOC
TTTACTGAGACTACGG	T.NK.cells
TTTCACATCGATCCCT	T.NK.cells
TTTCATGTCCAGTGTA	T.NK.cells
TTTCATGTCTAGCAAC	T.NK.cells
TTTCCTCAGCTGGCCT	Myeloid.cells
TTTCCTCCAAGCACAG	T.NK.cells
TTTCCTCGTGATCATC	T.NK.cells
TTTCGATGTAGGTACG	T.NK.cells
TTTGGTTCAGACACCC	T.NK.cells
