"barcodes"	"celltype_final"
"AAACGCTTCATGCCAA"	"T.NK.cells"
"AACAAAGCACACAGCC"	"HGSOC"
"AACAAGACAACCAATC"	"HGSOC"
"AACAAGACACAAATAG"	"T.NK.cells"
"AACCATGTCTTAGCCC"	"T.NK.cells"
"AACCTTTTCGTGGACC"	"HGSOC"
"AACGGGACAACCCTCT"	"T.NK.cells"
"AACGGGACATATGAAG"	"T.NK.cells"
"AACGGGATCGTAGTGT"	"HGSOC"
"AACGTCATCGATAACC"	"HGSOC"
"AAGAACACAGAGTTGG"	"HGSOC"
"AAGCATCGTAGCTTGT"	"HGSOC"
"AAGGAATAGAGAAGGT"	"uncertain"
"AAGTACCGTGAGAGGG"	"HGSOC"
"AAGTCGTGTTTCGTGA"	"T.NK.cells"
"AAGTCGTTCGCCAGTG"	"HGSOC"
"AAGTGAATCTGTCGTC"	"HGSOC"
"AATGACCTCCCAGCGA"	"HGSOC"
"AATGCCACACCCTATC"	"uncertain"
"AATGCCACAGTCTTCC"	"uncertain"
"ACAACCAAGTAACCTC"	"Fibroblasts"
"ACAACCACACGCTTAA"	"HGSOC"
"ACAAGCTCACCGTCTT"	"Endothelial.cells"
"ACACGCGAGAGATTCA"	"HGSOC"
"ACACGCGTCATAGCAC"	"HGSOC"
"ACACTGAAGGTGAGCT"	"T.NK.cells"
"ACATCGACAGTCGCTG"	"T.NK.cells"
"ACATCGACATGTTCAG"	"T.NK.cells"
"ACCAACAGTCTACACA"	"uncertain"
"ACCACAAGTTCTCCTG"	"HGSOC"
"ACCCTCACAGCGTACC"	"Myeloid.cells"
"ACCTGTCCAATAAGGT"	"T.NK.cells"
"ACGATCATCCTCACTG"	"T.NK.cells"
"ACGATGTAGATAGCAT"	"Fibroblasts"
"ACGATGTGTAACGATA"	"uncertain"
"ACGCACGTCTTCCCAG"	"HGSOC"
"ACGGAAGCAGACTGCC"	"HGSOC"
"ACGGTTAGTACGCTAT"	"HGSOC"
"ACGTAACTCCAGGACC"	"HGSOC"
"ACGTACAAGGTAATCA"	"HGSOC"
"ACGTAGTGTGGCCCAT"	"T.NK.cells"
"ACGTTCCCAGTGCCTG"	"T.NK.cells"
"ACTCCCATCTGGCCAG"	"T.NK.cells"
"ACTGTCCTCCTTCAGC"	"HGSOC"
"ACTTAGGGTGTTACTG"	"Myeloid.cells"
"ACTTATCAGTTCATGC"	"HGSOC"
"ACTTCGCGTACCAGAG"	"HGSOC"
"ACTTTCAAGTCCCGAC"	"HGSOC"
"AGAACAATCACACCGG"	"HGSOC"
"AGAACCTAGGAGACCT"	"HGSOC"
"AGACAGGCATCAGCTA"	"uncertain"
"AGACCCGCAGGGCTTC"	"T.NK.cells"
"AGACTCATCAGCGCGT"	"HGSOC"
"AGAGAATAGCGTTACT"	"HGSOC"
"AGAGAATTCCCATAGA"	"HGSOC"
"AGAGCCCTCGGTCGAC"	"HGSOC"
"AGATAGATCTCGGGAC"	"Myeloid.cells"
"AGATGAATCCCAAGCG"	"HGSOC"
"AGATGCTTCTAACACG"	"HGSOC"
"AGCCAATGTAACAAGT"	"T.NK.cells"
"AGCCACGGTGCGTTTA"	"HGSOC"
"AGCCAGCGTGTTTCTT"	"HGSOC"
"AGCTACACACCGGCTA"	"T.NK.cells"
"AGCTCAATCAGCAGAG"	"HGSOC"
"AGCTCAATCTAGCAAC"	"HGSOC"
"AGGAATATCAGAGCAG"	"T.NK.cells"
"AGGACGAGTTGCCATA"	"T.NK.cells"
"AGGAGGTTCCTAACAG"	"HGSOC"
"AGGATAAGTCTTGAAC"	"T.NK.cells"
"AGGATCTTCTTGGTCC"	"T.NK.cells"
"AGGCATTAGCCGTTAT"	"T.NK.cells"
"AGGCTGCCAGAAATCA"	"Myeloid.cells"
"AGGCTGCGTTGATGTC"	"HGSOC"
"AGGGTGACACACCTGG"	"Myeloid.cells"
"AGGTCATAGACGTCCC"	"T.NK.cells"
"AGTACTGGTTCCTAGA"	"T.NK.cells"
"AGTAGTCGTTGCGTAT"	"T.NK.cells"
"AGTCAACGTAGGCAAC"	"Endothelial.cells"
"AGTCACACATCGTCCT"	"T.NK.cells"
"AGTGACTAGGATACCG"	"T.NK.cells"
"AGTGCCGCACTCAGAT"	"HGSOC"
"AGTGCCGCAGTGGGTA"	"HGSOC"
"AGTGTTGGTATGAGGC"	"T.NK.cells"
"AGTTAGCAGCTTGTGT"	"HGSOC"
"AGTTAGCGTCTGATAC"	"HGSOC"
"ATACTTCTCTCTGCCA"	"HGSOC"
"ATAGACCGTCCAAGAG"	"HGSOC"
"ATAGGCTGTAGCGTCC"	"HGSOC"
"ATCACTTAGACAAGCC"	"T.NK.cells"
"ATCCACCTCTGGGATT"	"HGSOC"
"ATCCATTTCTTTGGAG"	"HGSOC"
"ATCCGTCCAGCACCCA"	"HGSOC"
"ATCGATGTCGCTGATA"	"T.NK.cells"
"ATCGGCGGTGACATCT"	"HGSOC"
"ATCGTGACACGCCACA"	"T.NK.cells"
"ATCTCTAGTGGTCCGT"	"T.NK.cells"
"ATCTTCACATGTTCGA"	"T.NK.cells"
"ATGAAAGCACGCGCAT"	"Myeloid.cells"
"ATGAGTCCAAACCACT"	"HGSOC"
"ATGAGTCCAGATTTCG"	"B.cells"
"ATTACTCCACCAGCCA"	"uncertain"
"ATTACTCGTGCATGAG"	"HGSOC"
"ATTACTCTCGCTTAAG"	"T.NK.cells"
"ATTCACTAGGTGCCTC"	"T.NK.cells"
"ATTCACTTCTATCGTT"	"Endothelial.cells"
"ATTCCATTCAGGACGA"	"Myeloid.cells"
"CAAAGAAAGAGAGTGA"	"HGSOC"
"CAACAACAGTGCGACA"	"Fibroblasts"
"CAACCAACAGTCTTCC"	"T.NK.cells"
"CAACCTCCAGGAATAT"	"Myeloid.cells"
"CAACCTCTCGAGGCAA"	"T.NK.cells"
"CAAGAGGAGGGATGTC"	"T.NK.cells"
"CACAGATTCATAGACC"	"T.NK.cells"
"CACATGAGTGCATCTA"	"Myeloid.cells"
"CACTTCGGTTGCGTAT"	"T.NK.cells"
"CAGATCAAGTTGGCGA"	"HGSOC"
"CAGCAATAGTTACGGG"	"Mesothelial.cells"
"CAGCACGAGAATCCCT"	"T.NK.cells"
"CAGTGCGAGGACAGTC"	"HGSOC"
"CAGTGCGTCTTAAGGC"	"HGSOC"
"CATAAGCGTACAGCGA"	"T.NK.cells"
"CATACAGAGGGAGAAT"	"T.NK.cells"
"CATAGACTCAAGAGTA"	"HGSOC"
"CATCAAGCAGCGTGAA"	"uncertain"
"CATCGCTAGGAGCAAA"	"T.NK.cells"
"CATCGCTGTGAATTGA"	"T.NK.cells"
"CATCGGGTCGCCGATG"	"HGSOC"
"CATGCCTCACAGTACT"	"HGSOC"
"CATGGATAGATGATTG"	"HGSOC"
"CATGGATAGGACAGTC"	"T.NK.cells"
"CATGGATCATGGAATA"	"T.NK.cells"
"CATGGATGTCTCCCTA"	"T.NK.cells"
"CATTCATCAAAGTGTA"	"T.NK.cells"
"CATTCCGGTCTCGGAC"	"HGSOC"
"CATTCTACAACTGCTA"	"T.NK.cells"
"CATTTCAAGCTAATGA"	"T.NK.cells"
"CCAATGACAGATGCGA"	"T.NK.cells"
"CCAATTTGTAGCGCCT"	"T.NK.cells"
"CCACAAAGTAAGCGGT"	"B.cells"
"CCACGTTGTTCGAACT"	"Myeloid.cells"
"CCCTAACAGGAACGAA"	"T.NK.cells"
"CCCTAACAGGGCAGGA"	"HGSOC"
"CCCTCTCCACGGCTAC"	"HGSOC"
"CCCTGATAGCAAATGT"	"HGSOC"
"CCGATCTCATCGTTCC"	"HGSOC"
"CCGGTGATCTAGAGCT"	"T.NK.cells"
"CCTAAGACAGGAATCG"	"Myeloid.cells"
"CCTCCAACACACCGCA"	"HGSOC"
"CCTCTCCGTAACGGTG"	"T.NK.cells"
"CCTTGTGCAAGTTCGT"	"HGSOC"
"CCTTGTGCAATCGCAT"	"T.NK.cells"
"CCTTGTGCATGGGTTT"	"HGSOC"
"CCTTTGGAGGCATTTC"	"T.NK.cells"
"CGAATTGGTCTTTATC"	"HGSOC"
"CGACAGCAGTATTGCC"	"HGSOC"
"CGAGTGCCACCCTGAG"	"T.NK.cells"
"CGAGTTACATGACAAA"	"HGSOC"
"CGATGGCAGCTAAGTA"	"HGSOC"
"CGCCATTCACCTGAAT"	"T.NK.cells"
"CGCCATTCATCTTCGC"	"HGSOC"
"CGGAACCAGAGGTTAT"	"T.NK.cells"
"CGGAGAATCTGAGAGG"	"HGSOC"
"CGGGACTCAGATCATC"	"T.NK.cells"
"CGGGTCAGTAAGGCTG"	"HGSOC"
"CGTCAAAAGTCGCTAT"	"Mesothelial.cells"
"CGTGTCTCACTTGTGA"	"T.NK.cells"
"CGTTCTGGTACGATTC"	"HGSOC"
"CGTTCTGTCCTGTAAG"	"T.NK.cells"
"CTAAGTGTCTTGTGCC"	"T.NK.cells"
"CTACATTGTACGTAGG"	"Endothelial.cells"
"CTACATTGTGTACAGG"	"HGSOC"
"CTACCCAAGCGTTAGG"	"HGSOC"
"CTACCCAGTTTATGCG"	"HGSOC"
"CTACCTGTCGTCAAAC"	"HGSOC"
"CTACCTGTCTAGACAC"	"HGSOC"
"CTCAACCTCCGGTTCT"	"HGSOC"
"CTCAAGATCACGGGCT"	"T.NK.cells"
"CTCATTAGTGCAACGA"	"HGSOC"
"CTCCCTCAGTAAGCAT"	"T.NK.cells"
"CTCCTCCAGGTTTGAA"	"T.NK.cells"
"CTCCTTTAGCGCTGAA"	"T.NK.cells"
"CTCCTTTCAGTCTGGC"	"HGSOC"
"CTCCTTTGTGATTGGG"	"Myeloid.cells"
"CTCTCAGCAGCTGCCA"	"T.NK.cells"
"CTGAGGCGTTTGCAGT"	"HGSOC"
"CTGATCCAGTCCCGGT"	"HGSOC"
"CTGCAGGCAACGGGTA"	"HGSOC"
"CTGCAGGCACTCCGAG"	"T.NK.cells"
"CTGCATCGTTGGTACT"	"HGSOC"
"CTGCCTAAGACCTCCG"	"HGSOC"
"CTGCCTAAGGAAAGGT"	"T.NK.cells"
"CTGCGAGGTCGTACTA"	"T.NK.cells"
"CTGTATTCAGCTGTTA"	"T.NK.cells"
"CTTCCGAGTGGCTTAT"	"HGSOC"
"CTTCCTTAGCTGGTGA"	"HGSOC"
"CTTCTAATCCGATAAC"	"HGSOC"
"CTTGATTGTAGATGTA"	"T.NK.cells"
"CTTGATTTCCGAGAAG"	"T.NK.cells"
"GAAATGACAACGATTC"	"HGSOC"
"GAACGTTGTGGATTTC"	"HGSOC"
"GAACGTTTCTACCCAC"	"HGSOC"
"GAAGTAAGTAATGATG"	"HGSOC"
"GAAGTAAGTCACCTTC"	"HGSOC"
"GAAGTAAGTTCAATCG"	"T.NK.cells"
"GAATCACTCCACGTGG"	"Myeloid.cells"
"GAATCGTAGAGTTGTA"	"T.NK.cells"
"GACACGCCAACTGCTA"	"T.NK.cells"
"GACAGCCAGACTCATC"	"HGSOC"
"GACATCAGTGTGGTCC"	"T.NK.cells"
"GACCCAGCACTATCGA"	"HGSOC"
"GACCCTTTCAACACGT"	"HGSOC"
"GACTATGAGAGGGTAA"	"HGSOC"
"GACTATGAGATAGTGT"	"Myeloid.cells"
"GACTATGCAAGCTCTA"	"Mesothelial.cells"
"GACTCTCGTTGCTCGG"	"HGSOC"
"GACTGATGTTAGAAAC"	"HGSOC"
"GACTTCCCATACAGCT"	"T.NK.cells"
"GAGAAATCACCCATAA"	"uncertain"
"GAGAAATTCTCGTGAA"	"HGSOC"
"GAGACTTAGGTTGTTC"	"T.NK.cells"
"GAGATGGAGAATCGAT"	"HGSOC"
"GAGATGGTCAGCGCAC"	"T.NK.cells"
"GAGCCTGGTCGATTCA"	"HGSOC"
"GAGGGATGTTTGGAAA"	"T.NK.cells"
"GAGGGTAGTGAGAGGG"	"HGSOC"
"GAGGGTAGTGGAAGTC"	"T.NK.cells"
"GAGTGAGGTCCTGTCT"	"T.NK.cells"
"GAGTGAGTCGCTGACG"	"T.NK.cells"
"GAGTTTGTCTGTGCGG"	"T.NK.cells"
"GATAGAAAGGTTATAG"	"T.NK.cells"
"GATAGCTCAACTCCAA"	"HGSOC"
"GATCACACAGCTGTAT"	"Myeloid.cells"
"GATCAGTGTTCTCACC"	"B.cells"
"GATCAGTTCTCAACCC"	"HGSOC"
"GATCATGCAGCGTGCT"	"HGSOC"
"GATCCCTGTACAGAAT"	"T.NK.cells"
"GATGAGGTCAACCTTT"	"T.NK.cells"
"GATGTTGAGACTCAAA"	"Myeloid.cells"
"GATTCGATCTAAACGC"	"HGSOC"
"GATTCTTCAGTAACAA"	"T.NK.cells"
"GATTTCTCAATCTCGA"	"HGSOC"
"GCACATACACGTCGGT"	"HGSOC"
"GCACGTGGTCGAACAG"	"HGSOC"
"GCATGATGTACTGGGA"	"HGSOC"
"GCCCAGAAGAAGTATC"	"HGSOC"
"GCCCGAATCTAACGGT"	"T.NK.cells"
"GCCGATGAGACGTCGA"	"HGSOC"
"GCCGATGTCGCTTTAT"	"uncertain"
"GCGGAAAGTCCACTCT"	"HGSOC"
"GCTCAAAAGTCATGGG"	"T.NK.cells"
"GCTGCAGAGAGTTGCG"	"Fibroblasts"
"GGAACCCTCACAAGGG"	"T.NK.cells"
"GGAACCCTCGACCTAA"	"HGSOC"
"GGAAGTGCAGGACTAG"	"T.NK.cells"
"GGAATCTAGTTGAATG"	"T.NK.cells"
"GGAATGGTCACACCGG"	"T.NK.cells"
"GGACGTCAGTTACGAA"	"T.NK.cells"
"GGACGTCTCTCGCTTG"	"T.NK.cells"
"GGAGAACTCAGACAAA"	"T.NK.cells"
"GGATGTTCAGAAGTTA"	"HGSOC"
"GGCACGTTCTAAGGAA"	"HGSOC"
"GGCGTCAAGTAACGTA"	"T.NK.cells"
"GGCTGTGTCGGACAAG"	"T.NK.cells"
"GGGACCTTCTGTTGGA"	"Myeloid.cells"
"GGGATCCGTCAGACGA"	"HGSOC"
"GGGCCATAGTATTCCG"	"T.NK.cells"
"GGGCCATCAGTCTTCC"	"HGSOC"
"GGGCGTTAGGCAGGGA"	"T.NK.cells"
"GGGCGTTCAGCGACCT"	"T.NK.cells"
"GGGCTCATCTTACCAT"	"T.NK.cells"
"GGGTCTGAGTATTGCC"	"T.NK.cells"
"GGGTTATCACGGCTAC"	"HGSOC"
"GGGTTATTCGATTTCT"	"Myeloid.cells"
"GGTAGAGGTTGGTACT"	"T.NK.cells"
"GGTCACGCACAGTATC"	"T.NK.cells"
"GGTGAAGAGATGAAGG"	"HGSOC"
"GGTGGCTCACGTACAT"	"Fibroblasts"
"GGTTCTCAGTAATCCC"	"uncertain"
"GTAACACCAATCGCAT"	"T.NK.cells"
"GTAACCATCGAGCCTG"	"T.NK.cells"
"GTAAGTCCAAACTCTG"	"HGSOC"
"GTAAGTCTCTAACGGT"	"T.NK.cells"
"GTAATCGGTCTGTAGT"	"HGSOC"
"GTACAACAGTAACCTC"	"T.NK.cells"
"GTAGTACAGATACATG"	"HGSOC"
"GTCAGCGAGAGCCGAT"	"HGSOC"
"GTCAGCGGTTCGAGCC"	"HGSOC"
"GTCATCCTCCCGAACG"	"uncertain"
"GTCCACTGTTCGGTCG"	"Fibroblasts"
"GTCCTCAGTTGTCTAG"	"HGSOC"
"GTCCTCATCTCCCATG"	"HGSOC"
"GTCTAGAGTACCAATC"	"HGSOC"
"GTCTCACAGGTTCACT"	"T.NK.cells"
"GTCTGTCTCAGGCGAA"	"T.NK.cells"
"GTCTGTCTCCAAGCTA"	"T.NK.cells"
"GTGAGCCTCGAGAGAC"	"T.NK.cells"
"GTGAGCCTCTCCGCAT"	"T.NK.cells"
"GTGAGCCTCTGGTGGC"	"uncertain"
"GTGATGTAGTCACTCA"	"T.NK.cells"
"GTGCACGAGCTGAAGC"	"HGSOC"
"GTGCAGCCACAAGGTG"	"HGSOC"
"GTGCTTCTCAGCCTTC"	"HGSOC"
"GTGGCGTGTTTGGGTT"	"T.NK.cells"
"GTGGGAAAGTTTAGGA"	"T.NK.cells"
"GTGGGAAGTAGCTGTT"	"T.NK.cells"
"GTGGGAATCCAGTTCC"	"HGSOC"
"GTGTGATGTACTCGCG"	"HGSOC"
"GTTACCCGTCGTGGTC"	"HGSOC"
"GTTACGATCAGTGTCA"	"HGSOC"
"GTTGCGGGTCATCCGG"	"HGSOC"
"GTTGCTCCAAGGCAAC"	"T.NK.cells"
"GTTGTAGGTGGTGATG"	"T.NK.cells"
"TAACGACGTTGAGAGC"	"Endothelial.cells"
"TAACGACTCCACAAGT"	"T.NK.cells"
"TAAGCGTCAACTGTGT"	"Mesothelial.cells"
"TAAGTCGCAAGTGGTG"	"HGSOC"
"TAAGTCGCACCCTGAG"	"HGSOC"
"TACATTCAGAGCTGCA"	"HGSOC"
"TACCGAAAGAACGTGC"	"Mesothelial.cells"
"TACCTGCGTGCAACGA"	"T.NK.cells"
"TACTTACTCACCCTCA"	"T.NK.cells"
"TACTTGTAGTCCCAGC"	"HGSOC"
"TAGACCATCCGTGGCA"	"HGSOC"
"TAGATCGGTATTGACC"	"HGSOC"
"TAGGAGGGTAGTCTGT"	"uncertain"
"TAGGAGGTCCATAGAC"	"T.NK.cells"
"TAGGTTGAGAAGCTGC"	"HGSOC"
"TAGTGCACATAGTCAC"	"T.NK.cells"
"TATACCTGTCGTCTCT"	"HGSOC"
"TATCTTGCACACCTAA"	"HGSOC"
"TATCTTGTCACTACGA"	"HGSOC"
"TATGTTCAGTAGTCTC"	"HGSOC"
"TATTCCACACAAGTGG"	"HGSOC"
"TATTGCTCAGCACACC"	"HGSOC"
"TCAAGACCAGGCTCTG"	"T.NK.cells"
"TCACAAGCATGACGTT"	"T.NK.cells"
"TCACAAGGTTTGCAGT"	"HGSOC"
"TCACGCTCAAGTGGAC"	"HGSOC"
"TCACGGGCAGGAAGTC"	"Myeloid.cells"
"TCACTATTCGACATTG"	"uncertain"
"TCAGCCTTCACCTGTC"	"HGSOC"
"TCAGTGAAGCGCCTAC"	"T.NK.cells"
"TCATACTCAGGGTTGA"	"HGSOC"
"TCATACTTCAAAGGAT"	"HGSOC"
"TCATCATGTTACGCCG"	"T.NK.cells"
"TCATCCGCATGGGATG"	"HGSOC"
"TCATGCCAGTGATCGG"	"Endothelial.cells"
"TCATGTTGTACAATAG"	"Mesothelial.cells"
"TCATTACAGCAGCCTC"	"T.NK.cells"
"TCATTACAGGGCTGAT"	"T.NK.cells"
"TCATTCACACTCTAGA"	"T.NK.cells"
"TCATTGTGTCTTCGAA"	"HGSOC"
"TCATTGTTCTGCGGAC"	"HGSOC"
"TCCACGTCATAACAGA"	"T.NK.cells"
"TCCATCGAGCACAAAT"	"HGSOC"
"TCCCAGTCATCTCGTC"	"HGSOC"
"TCCGAAACAAGCAGGT"	"T.NK.cells"
"TCCGTGTCAGTAGTGG"	"HGSOC"
"TCCTGCATCCTTCACG"	"T.NK.cells"
"TCGAAGTCATAACAGA"	"HGSOC"
"TCGAAGTTCGCTCATC"	"T.NK.cells"
"TCGACGGCAAAGCAAT"	"T.NK.cells"
"TCGCACTCAAGCTGTT"	"HGSOC"
"TCGCAGGAGTCAGGGT"	"T.NK.cells"
"TCGCAGGCAATTGGTC"	"HGSOC"
"TCGCAGGGTCGAGTGA"	"T.NK.cells"
"TCGGGACCAGGTGTTT"	"T.NK.cells"
"TCGTAGAAGGTGCCTC"	"T.NK.cells"
"TCGTCCAAGCGCTGAA"	"Mesothelial.cells"
"TCTAACTTCAGGACAG"	"T.NK.cells"
"TCTACCGAGAAGTCAT"	"T.NK.cells"
"TCTCCGACAATCCAGT"	"T.NK.cells"
"TCTGCCAAGCACCGTC"	"HGSOC"
"TCTGGCTGTACTCGAT"	"T.NK.cells"
"TCTTTGAAGGATGTTA"	"T.NK.cells"
"TGAATGCGTGGCTGCT"	"Myeloid.cells"
"TGACTCCTCCGAACGC"	"HGSOC"
"TGAGACTTCCGTATAG"	"HGSOC"
"TGAGCATAGTGAGGCT"	"T.NK.cells"
"TGAGCATGTCTAGGCC"	"HGSOC"
"TGAGGAGAGAGCGACT"	"HGSOC"
"TGAGGTTGTTGGGATG"	"HGSOC"
"TGATTTCCATGTGGTT"	"uncertain"
"TGATTTCTCTAGTGTG"	"T.NK.cells"
"TGCAGTACAGCTGCCA"	"T.NK.cells"
"TGCATCCGTGGTTTAC"	"Myeloid.cells"
"TGCATGACATGACGAG"	"HGSOC"
"TGCATGAGTAGCGCCT"	"T.NK.cells"
"TGCGACGCAATTGGTC"	"T.NK.cells"
"TGCGGCAGTCGAGATG"	"HGSOC"
"TGCGGCATCCTCACGT"	"Endothelial.cells"
"TGCGGGTAGGATTTGA"	"HGSOC"
"TGCGGGTTCTTACCGC"	"T.NK.cells"
"TGCTGAACAGGCTACC"	"HGSOC"
"TGCTTCGGTCCCACGA"	"HGSOC"
"TGGAGAGAGGAGAATG"	"T.NK.cells"
"TGGAGAGAGTTGGAAT"	"HGSOC"
"TGGAGAGCAATCTGCA"	"Myeloid.cells"
"TGGATGTCAACAACAA"	"T.NK.cells"
"TGGGAAGAGTCCTGCG"	"HGSOC"
"TGGGAAGGTTCTGAGT"	"T.NK.cells"
"TGGGAAGTCCCGAGTG"	"T.NK.cells"
"TGGGCGTAGCTACAAA"	"HGSOC"
"TGGGCGTGTCTAACTG"	"HGSOC"
"TGGGTTATCTCTCGAC"	"HGSOC"
"TGGTACAAGACTCATC"	"T.NK.cells"
"TGGTGATGTCGTGGTC"	"HGSOC"
"TGGTTAGTCCTTCTGG"	"T.NK.cells"
"TGTAAGCGTACGCTAT"	"HGSOC"
"TGTAAGCTCTACCCAC"	"Endothelial.cells"
"TGTCCCAGTTGTAGCT"	"HGSOC"
"TGTCCTGGTTCAAGTC"	"HGSOC"
"TGTGCGGGTGTGGTCC"	"HGSOC"
"TGTGGCGAGTGTTGAA"	"T.NK.cells"
"TGTGTGATCACTCGAA"	"HGSOC"
"TGTTACTAGAGCAACC"	"Myeloid.cells"
"TGTTGAGAGAAGCCAC"	"T.NK.cells"
"TGTTGAGGTCCGATCG"	"HGSOC"
"TGTTGGATCTGCTCTG"	"T.NK.cells"
"TGTTTGTTCTCTATGT"	"HGSOC"
"TTAATCCAGTGGTTCT"	"T.NK.cells"
"TTACCGCCAAACGTGG"	"HGSOC"
"TTACGCCAGGGTACAC"	"HGSOC"
"TTACGCCGTTGGGTTT"	"HGSOC"
"TTACGTTAGGACAAGA"	"HGSOC"
"TTAGGCACAATTGCGT"	"T.NK.cells"
"TTCAATCCAATCGAAA"	"B.cells"
"TTCCAATAGCAGCAGT"	"HGSOC"
"TTCCACGTCACTGGGC"	"T.NK.cells"
"TTCCGGTTCTCATGGA"	"T.NK.cells"
"TTCCGTGAGTTCCGGC"	"HGSOC"
"TTCCGTGCATACCAGT"	"HGSOC"
"TTCCTAAAGGAAACGA"	"T.NK.cells"
"TTCCTAATCAAAGCCT"	"uncertain"
"TTCGATTGTCGATGCC"	"Myeloid.cells"
"TTCTAGTCAACTGCCG"	"T.NK.cells"
"TTCTTCCGTGTCTAAC"	"HGSOC"
"TTGAACGGTCAAAGCG"	"T.NK.cells"
"TTGACCCTCTTTGGAG"	"T.NK.cells"
"TTGATGGCAAGTGGCA"	"HGSOC"
"TTGCATTTCCAGGACC"	"HGSOC"
"TTGCGTCAGCAAACAT"	"HGSOC"
"TTGCGTCGTAGGAGGG"	"Myeloid.cells"
"TTGGATGCAGGACGAT"	"HGSOC"
"TTGGGTACATCATGAC"	"HGSOC"
"TTGTTTGAGAGTTGTA"	"Myeloid.cells"
"TTTACCAAGAATCGTA"	"HGSOC"
"TTTACTGAGCCTGAGA"	"T.NK.cells"
"TTTATGCCAGGACATG"	"HGSOC"
"TTTCAGTAGTAGGTTA"	"T.NK.cells"
"TTTCAGTTCGCCAGTG"	"HGSOC"
"TTTCGATAGTTACTCG"	"T.NK.cells"
"TTTGATCTCGTGAGAG"	"HGSOC"
