"barcodes"	"celltype_final"
"AAACCCATCGAGATAA"	"T.NK.cells"
"AAACCCATCTATCGGA"	"HGSOC"
"AAACGCTAGGAGGTTC"	"HGSOC"
"AAAGGATCAATTGCCA"	"T.NK.cells"
"AAAGGGCAGGACTATA"	"Mast.cells"
"AAAGGTATCCCATACC"	"T.NK.cells"
"AAAGTGAGTTTGTTCT"	"T.NK.cells"
"AAAGTGATCCAACTGA"	"HGSOC"
"AAATGGAAGGTCGAGT"	"Fibroblasts"
"AACAACCTCAGGAAGC"	"T.NK.cells"
"AACAGGGCAAGCGCAA"	"Mesothelial.cells"
"AACCCAATCGACTCCT"	"HGSOC"
"AACCCAATCGGAGTGA"	"Myeloid.cells"
"AACCTGAGTGCGGTAA"	"uncertain"
"AACCTTTTCTGCAGCG"	"T.NK.cells"
"AAGACTCCAAGTCATC"	"Mesothelial.cells"
"AAGATAGTCCTCGCAT"	"T.NK.cells"
"AAGCCATGTGCGGTAA"	"T.NK.cells"
"AAGCGAGTCAACTGGT"	"uncertain"
"AAGCGTTGTTGGAGAC"	"T.NK.cells"
"AAGTCGTGTCTGTGGC"	"T.NK.cells"
"AAGTTCGTCCATAGAC"	"T.NK.cells"
"AATAGAGTCTGAACGT"	"HGSOC"
"AATGAAGAGTTCCGTA"	"Mesothelial.cells"
"AATGACCAGATGGCAC"	"Mesothelial.cells"
"AATGCCAAGACATATG"	"T.NK.cells"
"ACAAGCTCACAAAGTA"	"T.NK.cells"
"ACACCAAAGATAGTGT"	"B.cells"
"ACACCAAAGGTCCAGA"	"Myeloid.cells"
"ACAGAAACAACGTAAA"	"Myeloid.cells"
"ACAGAAATCCGATGTA"	"B.cells"
"ACAGCCGAGCCACTCG"	"T.NK.cells"
"ACATCCCAGCCACCGT"	"T.NK.cells"
"ACATCCCAGCCTTTCC"	"T.NK.cells"
"ACATGCAAGTTCACTG"	"T.NK.cells"
"ACATGCAGTACGGATG"	"Mast.cells"
"ACCAACATCTAATTCC"	"T.NK.cells"
"ACCATTTCATAACCCA"	"T.NK.cells"
"ACCCAAACAAAGCAAT"	"Fibroblasts"
"ACCCTCATCGGTAGGA"	"T.NK.cells"
"ACCCTTGAGTCCGCCA"	"T.NK.cells"
"ACCGTTCGTTACCCAA"	"T.NK.cells"
"ACCTGTCCATCTTAGG"	"T.NK.cells"
"ACGATGTAGAGAGCCT"	"Mesothelial.cells"
"ACGATGTCAGATCCAT"	"T.NK.cells"
"ACGATGTTCTTGAACG"	"T.NK.cells"
"ACGCACGGTAGCTTGT"	"T.NK.cells"
"ACGCACGGTCCAAATC"	"B.cells.naive"
"ACGGGTCAGACTGAGC"	"T.NK.cells"
"ACGGGTCCAGGCCCTA"	"uncertain"
"ACGGTCGCAAGCGGAT"	"T.NK.cells"
"ACGTAACCATTGGCAT"	"HGSOC"
"ACGTCCTCAGCCTTCT"	"T.NK.cells"
"ACGTTCCCAGATGCGA"	"T.NK.cells"
"ACGTTCCGTACATTGC"	"Myeloid.cells"
"ACTACGACACACCGCA"	"uncertain"
"ACTACGACAGAGGAAA"	"T.NK.cells"
"ACTATCTGTCGCACGT"	"HGSOC"
"ACTATGGGTGGAACAC"	"T.NK.cells"
"ACTATTCGTAGAGTTA"	"HGSOC"
"ACTGCAATCTCCCAAC"	"T.NK.cells"
"ACTGTCCAGGCTTAAA"	"Endothelial.cells"
"ACTTAGGGTTACGTAC"	"T.NK.cells"
"ACTTCCGGTGTGAGCA"	"HGSOC"
"ACTTTGTTCATGCATG"	"T.NK.cells"
"AGAAATGGTCGGTGAA"	"HGSOC"
"AGAACCTGTCAAATCC"	"Mast.cells"
"AGAACCTTCAAAGAAC"	"Myeloid.cells"
"AGAGAGCGTGACCTGC"	"HGSOC"
"AGAGCCCGTCTACTGA"	"Mast.cells"
"AGATGAAAGATTCGAA"	"Myeloid.cells"
"AGATGCTAGTTTCGAC"	"T.NK.cells"
"AGATGCTCAGGAAGTC"	"Mesothelial.cells"
"AGATGCTCAGTATTCG"	"T.NK.cells"
"AGATGCTGTGCCGTTG"	"T.NK.cells"
"AGCCACGAGCTGTCCG"	"HGSOC"
"AGCGATTCAAGCGCTC"	"T.NK.cells"
"AGCGCTGAGAAACCCG"	"B.cells"
"AGCGTATAGGCGTTGA"	"HGSOC"
"AGCGTATCAGTTCACA"	"T.NK.cells"
"AGCTCAAGTAACTGCT"	"T.NK.cells"
"AGGACGAGTACAGAAT"	"HGSOC"
"AGGACTTCAATTGCCA"	"B.cells"
"AGGCATTTCGCTGACG"	"T.NK.cells"
"AGGCCACAGCCAGAGT"	"Myeloid.cells"
"AGGGAGTGTTCATCGA"	"T.NK.cells"
"AGGGTCCCACTACACA"	"HGSOC"
"AGGTCATTCCTCACTG"	"uncertain"
"AGGTTGTAGAGGACTC"	"T.NK.cells"
"AGTACTGAGTCACTCA"	"Myeloid.cells"
"AGTAGTCTCAGTCATG"	"T.NK.cells"
"AGTCTCCAGACATATG"	"B.cells"
"AGTCTCCTCCGTGACG"	"T.NK.cells"
"AGTCTCCTCGTCTAAG"	"Mesothelial.cells"
"AGTGACTCACAACCGC"	"T.NK.cells"
"AGTGACTCAGACCATT"	"T.NK.cells"
"AGTGTTGTCTGTTGGA"	"Fibroblasts"
"ATACCTTCAGAGGTAC"	"HGSOC"
"ATACTTCCATAATCGC"	"T.NK.cells"
"ATAGGCTGTCCAGGTC"	"T.NK.cells"
"ATCACAGTCACTACTT"	"T.NK.cells"
"ATCACTTGTTCGAAGG"	"T.NK.cells"
"ATCATTCGTTTGATCG"	"Mesothelial.cells"
"ATCCACCTCGTAACTG"	"Myeloid.cells"
"ATCCATTCACTCTGCT"	"Myeloid.cells"
"ATCGGATCAGGCTATT"	"T.NK.cells"
"ATCGTAGCAAAGCGTG"	"T.NK.cells"
"ATCGTGATCTTGATTC"	"T.NK.cells"
"ATCTCTACACGTTCGG"	"T.NK.cells"
"ATCTCTACATGATCTG"	"Fibroblasts"
"ATGAGGGAGCTCTTCC"	"HGSOC"
"ATGATCGGTGCAGTGA"	"T.NK.cells"
"ATGCGATCAGAAATCA"	"Mesothelial.cells"
"ATGGAGGGTCGATTCA"	"T.NK.cells"
"ATGGAGGTCTCCGAGG"	"HGSOC"
"ATGGTTGGTGGTCTTA"	"HGSOC"
"ATTACTCAGGTACAGC"	"HGSOC"
"ATTCATCGTCAATCTG"	"HGSOC"
"ATTCCTATCACACCCT"	"T.NK.cells"
"ATTCGTTGTCAATCTG"	"T.NK.cells"
"ATTCTTGCAATCTCGA"	"B.cells"
"ATTGGGTTCATGTCAG"	"T.NK.cells"
"ATTTCACCAATCGCCG"	"HGSOC"
"ATTTCTGCAGACCAGA"	"T.NK.cells"
"CAACAACAGAGGCTGT"	"Monocytes"
"CAACAACGTCCAGCGT"	"T.NK.cells"
"CAACAACGTGCAACAG"	"T.NK.cells"
"CAACAGTTCTCTGAGA"	"T.NK.cells"
"CAACGATAGCGCTGCT"	"T.NK.cells"
"CAACGATTCATTCACT"	"T.NK.cells"
"CAACGGCCAATAGTAG"	"HGSOC"
"CAATGACAGACTCAAA"	"HGSOC"
"CACAGATCATGGCCAC"	"HGSOC"
"CACAGGCGTTCCGGTG"	"T.NK.cells"
"CACCAAAGTCAGCTTA"	"Myeloid.cells"
"CACGTTCAGCCTCACG"	"Mast.cells"
"CACGTTCAGCTGAAAT"	"Myeloid.cells"
"CACTAAGGTGACATCT"	"Myeloid.cells"
"CACTGAAAGCTGGAGT"	"T.NK.cells"
"CACTGAAGTGGCTGCT"	"B.cells"
"CACTGGGAGTAGTGCG"	"Mast.cells"
"CACTGTCCACAGTCGC"	"HGSOC"
"CACTTCGGTCGAATGG"	"T.NK.cells"
"CAGAGCCAGGCTCAAG"	"T.NK.cells"
"CAGAGCCGTACTCCGG"	"Myeloid.cells"
"CAGAGCCGTGAGATTA"	"T.NK.cells"
"CAGATACAGCATCCCG"	"T.NK.cells"
"CAGCACGAGCTCAGAG"	"T.NK.cells"
"CAGCACGGTTGCTGAT"	"T.NK.cells"
"CAGCAGCAGCCATTGT"	"HGSOC"
"CAGCAGCCAGGCTCTG"	"T.NK.cells"
"CAGCCAGAGCATCAGG"	"HGSOC"
"CAGCCAGCAGTCAGCC"	"HGSOC"
"CAGCGTGCAGTGTGCC"	"T.NK.cells"
"CAGCGTGTCTTGGTCC"	"T.NK.cells"
"CAGGCCACATCTAACG"	"T.NK.cells"
"CAGTTAGGTTGTGTTG"	"Endothelial.cells"
"CATAGACTCTTTGATC"	"Mesothelial.cells"
"CATCAAGAGCTACTAC"	"Mesothelial.cells"
"CATCCACTCGTCGATA"	"HGSOC"
"CATCCCACACTGTTCC"	"T.NK.cells"
"CATCCGTAGGCTCTCG"	"T.NK.cells"
"CATCCGTTCAGGTGTT"	"T.NK.cells"
"CATCGCTGTGACTATC"	"T.NK.cells"
"CATGAGTGTCTGCGCA"	"Myeloid.cells"
"CATGCAAAGCTCCGAC"	"Fibroblasts"
"CATGCAATCAGAGTTC"	"uncertain"
"CATGCGGGTTACCTGA"	"B.cells"
"CATGGATCAGTCGCTG"	"T.NK.cells"
"CATTCATTCAGTAGGG"	"T.NK.cells"
"CATTGAGCACAACCGC"	"B.cells"
"CATTGAGTCCTACCGT"	"T.NK.cells"
"CATTGTTGTATCGATC"	"uncertain"
"CATTTCACATGACGTT"	"T.NK.cells"
"CATTTCAGTCTTACAG"	"HGSOC"
"CCAAGCGCAACCGACC"	"T.NK.cells"
"CCACAAACACTTGGGC"	"Mesothelial.cells"
"CCATAAGTCAGTCATG"	"Myeloid.cells"
"CCATCACTCTATCGTT"	"HGSOC"
"CCCATTGCAATACCCA"	"T.NK.cells"
"CCCATTGGTGTGCCTG"	"Myeloid.cells"
"CCCTAACCAGGACATG"	"Mast.cells"
"CCCTCAAGTCATAACC"	"T.NK.cells"
"CCCTCTCAGACTTCGT"	"Mesothelial.cells"
"CCCTCTCTCATGGTAC"	"B.cells"
"CCGATCTTCTAGTCAG"	"Mesothelial.cells"
"CCGATGGGTTGCATAC"	"Myeloid.cells"
"CCGATGGTCGCTACAA"	"T.NK.cells"
"CCGCAAGAGTCTTGGT"	"T.NK.cells"
"CCGGACAAGGCTTTCA"	"T.NK.cells"
"CCGGTAGCAACTCGTA"	"T.NK.cells"
"CCGGTGATCCGTAGGC"	"Myeloid.cells"
"CCGTAGGCACCTCAGG"	"HGSOC"
"CCTCAACAGTATTGCC"	"Mesothelial.cells"
"CCTCAGTTCAGCCTTC"	"B.cells"
"CCTCATGCACACCTAA"	"Mesothelial.cells"
"CCTCCTCCAGCTATAC"	"HGSOC"
"CCTCTAGGTCGGCTAC"	"B.cells"
"CCTCTAGGTGGTTCTA"	"Myeloid.cells"
"CCTGTTGTCATTGCCC"	"Myeloid.cells"
"CCTTCAGAGATTGATG"	"T.NK.cells"
"CCTTGTGGTCGATTAC"	"T.NK.cells"
"CGACAGCAGACCAGCA"	"Fibroblasts"
"CGAGGAACAAGGGCAT"	"B.cells"
"CGAGGCTGTGATTCAC"	"Mast.cells"
"CGAGTGCAGGCCATAG"	"HGSOC"
"CGATGCGAGCGTGTTT"	"T.NK.cells"
"CGATGGCTCCAAATGC"	"T.NK.cells"
"CGATGGCTCGAAACAA"	"T.NK.cells"
"CGCAGGTTCCTGTTAT"	"Myeloid.cells"
"CGCCAGAGTCGATTCA"	"T.NK.cells"
"CGGAACCGTATTGGCT"	"T.NK.cells"
"CGGGACTAGCCTATTG"	"HGSOC"
"CGGGCATTCAATCTTC"	"T.NK.cells"
"CGGGTGTCATAGGTAA"	"Mesothelial.cells"
"CGGTCAGCATAGTCAC"	"T.NK.cells"
"CGGTCAGTCTCCTGAC"	"T.NK.cells"
"CGGTCAGTCTTTGGAG"	"T.NK.cells"
"CGTAATGAGAGAATCT"	"uncertain"
"CGTAATGCACCTAAAC"	"uncertain"
"CGTCAAACAACAGATA"	"uncertain"
"CGTCCATAGTTGTCGT"	"T.NK.cells"
"CGTGCTTCATGGTGGA"	"Endothelial.cells"
"CGTTAGAAGCAGGGAG"	"Myeloid.cells"
"CGTTAGATCTGGACCG"	"HGSOC"
"CGTTGGGCATAAGCAA"	"HGSOC"
"CGTTGGGGTCCCTGTT"	"Fibroblasts"
"CGTTGGGGTCTTTCAT"	"T.NK.cells"
"CTAACTTGTAGACTGG"	"T.NK.cells"
"CTACAGAAGTAAACGT"	"T.NK.cells"
"CTACATTAGGAGTATT"	"Mesothelial.cells"
"CTACCTGAGGCGACAT"	"Mesothelial.cells"
"CTACCTGCAATAACGA"	"Mast.cells"
"CTACGGGGTGAGATTA"	"T.NK.cells"
"CTACTATAGATGCCGA"	"T.NK.cells"
"CTACTATTCACGACTA"	"T.NK.cells"
"CTCAACCTCTAGTACG"	"T.NK.cells"
"CTCAATTCAAGTGACG"	"HGSOC"
"CTCAGAAGTACAGAGC"	"Mast.cells"
"CTCAGGGGTGTCTTCC"	"T.NK.cells"
"CTCAGTCGTTCGAACT"	"HGSOC"
"CTCATCGCAAAGGTTA"	"Monocytes"
"CTCCAACGTTCGGCGT"	"HGSOC"
"CTCCAACTCTGGAAGG"	"T.NK.cells"
"CTCCATGGTACTAGCT"	"T.NK.cells"
"CTCCATGTCCATCTGC"	"Mesothelial.cells"
"CTGAATGAGTTGAATG"	"T.NK.cells"
"CTGAGCGGTACCGGCT"	"B.cells"
"CTGATCCAGTGCCAGA"	"Myeloid.cells"
"CTGGCAGAGAGGGTAA"	"T.NK.cells"
"CTGGCAGTCATTACCT"	"Mesothelial.cells"
"CTGTACCCACATCCCT"	"T.NK.cells"
"CTGTAGAAGTCGAAAT"	"T.NK.cells"
"CTGTGGGCAGATCACT"	"T.NK.cells"
"CTTACCGTCGTGGACC"	"Mast.cells"
"CTTCAATTCCGTGGCA"	"T.NK.cells"
"CTTCCTTGTCCTGGGT"	"HGSOC"
"CTTCCTTGTTCATCTT"	"Fibroblasts"
"CTTCCTTTCAATGCAC"	"Myeloid.cells"
"CTTCTCTGTGGGACAT"	"Mast.cells"
"CTTCTCTTCAGAGCAG"	"B.cells"
"CTTGATTCAAGTGATA"	"Fibroblasts"
"CTTGATTGTGACAGGT"	"T.NK.cells"
"GAAACCTGTGTTCATG"	"T.NK.cells"
"GAAACCTTCACATACG"	"Fibroblasts"
"GAAATGAGTCATATGC"	"HGSOC"
"GAACGTTTCCACGTCT"	"T.NK.cells"
"GAAGAATAGAGTATAC"	"HGSOC"
"GACACGCCATCCTATT"	"Mesothelial.cells"
"GACCCAGCAGCAGAAC"	"HGSOC"
"GACGCTGAGCTAATGA"	"Myeloid.cells"
"GACGTTAGTCAAGTTC"	"HGSOC"
"GACTCAAAGAAGAGCA"	"T.NK.cells"
"GAGAAATTCCTACACC"	"Fibroblasts"
"GAGACCCAGGCATCTT"	"HGSOC"
"GAGACCCTCAAGTAAG"	"T.NK.cells"
"GAGCCTGGTAAGCGGT"	"Myeloid.cells"
"GAGCCTGTCGCATAGT"	"Fibroblasts"
"GAGTCTAGTTCCAGGC"	"Mast.cells"
"GAGTGAGTCGCATGAT"	"T.NK.cells"
"GAGTTACTCCTGCCAT"	"Fibroblasts"
"GAGTTTGGTGTCATCA"	"T.NK.cells"
"GATCGTACACGCCACA"	"T.NK.cells"
"GATGACTAGCTAGATA"	"Mast.cells"
"GATGCTATCTCTCTTC"	"T.NK.cells"
"GATTGGTAGCCAGACA"	"T.NK.cells"
"GCAACATTCTTTCCAA"	"Fibroblasts"
"GCAACCGAGAGCATCG"	"HGSOC"
"GCACATAAGACCGCCT"	"HGSOC"
"GCACATACAAGGCGTA"	"Mast.cells"
"GCACGTGAGGTAGTAT"	"Myeloid.cells"
"GCACTAATCGCCATAA"	"T.NK.cells"
"GCAGCCACACTCATAG"	"Fibroblasts"
"GCCAGGTAGCGTGCTC"	"T.NK.cells"
"GCCATTCCAGTTCCAA"	"Mesothelial.cells"
"GCCATTCTCTAGCCAA"	"HGSOC"
"GCCCAGAGTGTCCATA"	"Mast.cells"
"GCCCGAACAGGCGTTC"	"T.NK.cells"
"GCCGTGAAGGAACATT"	"T.NK.cells"
"GCCGTGAGTCCGGCAT"	"T.NK.cells"
"GCCGTGATCAGCAGAG"	"T.NK.cells"
"GCGAGAAAGGGACTGT"	"T.NK.cells"
"GCGGAAAAGACCTCAT"	"Myeloid.cells"
"GCGTGCATCCTTCGAC"	"T.NK.cells"
"GCGTGCATCTGGAAGG"	"uncertain"
"GCTACAATCGACCCAG"	"T.NK.cells"
"GCTACCTTCGAAGCAG"	"T.NK.cells"
"GCTGCAGAGGATGAGA"	"HGSOC"
"GCTGCAGTCAGAACCT"	"Endothelial.cells"
"GCTGGGTCACCTGTCT"	"Fibroblasts"
"GCTTCACGTTTACACG"	"B.cells"
"GCTTCACTCACCTACC"	"T.NK.cells"
"GGAACCCGTCTCACAA"	"Mesothelial.cells"
"GGAAGTGCAACTGCCG"	"T.NK.cells"
"GGAAGTGCACAGTACT"	"T.NK.cells"
"GGACGTCCATTATGCG"	"Fibroblasts"
"GGAGCAAGTCGATGCC"	"T.NK.cells"
"GGAGGTACAAACCGGA"	"T.NK.cells"
"GGCACGTCAGCTACTA"	"T.NK.cells"
"GGCTTGGTCCTTTAGT"	"Myeloid.cells"
"GGCTTTCGTTTGACAC"	"HGSOC"
"GGGACAACAATACGCT"	"Mesothelial.cells"
"GGGAGATCAGATTAAG"	"HGSOC"
"GGGAGTATCCATCAGA"	"B.cells"
"GGGTCACCATCCAACA"	"T.NK.cells"
"GGGTCACGTTCCAGGC"	"T.NK.cells"
"GGGTCTGTCATGAGAA"	"Myeloid.cells"
"GGGTGAATCGCTTGCT"	"Myeloid.cells"
"GGTAATCGTTCAAAGA"	"Myeloid.cells"
"GGTAGAGCATTCATCT"	"T.NK.cells"
"GGTCACGAGTATTGCC"	"T.NK.cells"
"GGTCACGCAGATTAAG"	"T.NK.cells"
"GGTCTGGAGCGCCATC"	"Mast.cells"
"GGTCTGGTCTTTGCGC"	"T.NK.cells"
"GGTGAAGAGTAAGACT"	"B.cells"
"GGTGAAGGTTCAGGTT"	"T.NK.cells"
"GGTTAACGTGGACTGA"	"T.NK.cells"
"GGTTCTCAGTAGTCTC"	"Fibroblasts"
"GGTTGTAAGGTGCTAG"	"Mast.cells"
"GTAAGTCGTAGTACGG"	"HGSOC"
"GTAATGCGTCCTATAG"	"HGSOC"
"GTACAGTGTTTGGAAA"	"Mesothelial.cells"
"GTAGAGGAGACGAGCT"	"Mesothelial.cells"
"GTAGGAGTCGACCACG"	"Fibroblasts"
"GTAGGTTAGTAGACCG"	"Mesothelial.cells"
"GTAGTACCAAAGCACG"	"T.NK.cells"
"GTATTTCGTTAATCGC"	"Myeloid.cells"
"GTCATCCAGGATTACA"	"T.NK.cells"
"GTCATTTTCAGCTCTC"	"B.cells"
"GTCGAATGTGCCCGTA"	"T.NK.cells"
"GTCGTTCCAGTGTGCC"	"T.NK.cells"
"GTCTAGATCTCCTACG"	"HGSOC"
"GTGACGCGTACGAGTG"	"T.NK.cells"
"GTGACGCTCGCCGTGA"	"Myeloid.cells"
"GTGAGTTAGGGTGGGA"	"T.NK.cells"
"GTGAGTTCAAAGCGTG"	"T.NK.cells"
"GTGAGTTCATCGAAGG"	"Fibroblasts"
"GTGAGTTGTGTTGACT"	"T.NK.cells"
"GTGATGTTCTAAGGAA"	"T.NK.cells"
"GTGCACGGTTTGAAAG"	"T.NK.cells"
"GTGCAGCGTCGGTACC"	"HGSOC"
"GTGGAGACAGAGGGTT"	"HGSOC"
"GTGTAACCATGTGTCA"	"HGSOC"
"GTGTCCTCACAGAGAC"	"T.NK.cells"
"GTGTGATCAGCGAACA"	"T.NK.cells"
"GTGTGGCGTCCGGCAT"	"Fibroblasts"
"GTGTGGCGTGGTTCTA"	"T.NK.cells"
"GTGTTAGAGAGCCTGA"	"T.NK.cells"
"GTGTTCCTCGTGGCTG"	"HGSOC"
"GTTACGAAGCTGAGTG"	"B.cells"
"GTTAGACAGCCGTAAG"	"T.NK.cells"
"GTTAGTGCACGATAGG"	"T.NK.cells"
"GTTAGTGGTCCATCTC"	"T.NK.cells"
"GTTAGTGTCATGACAC"	"Fibroblasts"
"GTTCGCTAGGTTCTTG"	"Myeloid.cells"
"GTTCGCTTCGGTAAGG"	"Myeloid.cells"
"GTTGCGGTCATGCGGC"	"T.NK.cells"
"GTTGCTCGTGGGCTCT"	"T.NK.cells"
"GTTGTGACAGTTCACA"	"HGSOC"
"GTTTACTCAACACACT"	"Mast.cells"
"TAACACGAGCTTTGTG"	"Mesothelial.cells"
"TAACCAGAGGAACGCT"	"HGSOC"
"TAAGCACCAATGGCAG"	"T.NK.cells"
"TAAGCACGTACAGTAA"	"HGSOC"
"TAAGCGTAGCACGTCC"	"B.cells"
"TAATCTCTCGTGTGGC"	"T.NK.cells"
"TACAACGGTCTCAGGC"	"Myeloid.cells"
"TACACCCGTACGACTT"	"HGSOC"
"TACATTCAGGAATTAC"	"Myeloid.cells"
"TACATTCGTTACCCAA"	"Fibroblasts"
"TACCCACAGACATAGT"	"Mesothelial.cells"
"TACCCGTTCGCACGGT"	"HGSOC"
"TACCGAAGTCGTTCAA"	"T.NK.cells"
"TACCTCGCACTAAACC"	"T.NK.cells"
"TACGTCCGTTTCACTT"	"HGSOC"
"TACTGCCGTAGAATGT"	"Fibroblasts"
"TACTTCAAGGACACTG"	"Mesothelial.cells"
"TACTTCACAAGCCTGC"	"B.cells"
"TACTTCAGTTATGACC"	"T.NK.cells"
"TACTTGTGTTAGGCTT"	"Mast.cells"
"TAGACTGGTAGGTACG"	"Mesothelial.cells"
"TAGCACAAGCATAGGC"	"HGSOC"
"TAGGAGGAGAGAGAAC"	"T.NK.cells"
"TAGGAGGCAACACAAA"	"T.NK.cells"
"TAGGGTTGTAGTCTTG"	"Fibroblasts"
"TAGGTTGGTCGGAACA"	"T.NK.cells"
"TAGTGCAGTACCTATG"	"Myeloid.cells"
"TATACCTCACTGGCCA"	"B.cells"
"TATACCTTCGACATCA"	"B.cells"
"TATATCCCACAAGCAG"	"T.NK.cells"
"TATTGCTCACGTAACT"	"Mast.cells"
"TATTTCGAGTGCCCGT"	"Fibroblasts"
"TATTTCGTCCCTATTA"	"HGSOC"
"TCAAGTGTCTGTCTCG"	"T.NK.cells"
"TCAATCTCACCGGAAA"	"T.NK.cells"
"TCAATCTGTTCGGTCG"	"B.cells"
"TCAATCTGTTTCACAG"	"HGSOC"
"TCACATTAGCATCTTG"	"Myeloid.cells"
"TCACATTGTATACGGG"	"B.cells"
"TCACTATAGATTAGCA"	"T.NK.cells"
"TCACTCGGTTCAGGTT"	"HGSOC"
"TCAGTTTGTCGTGATT"	"T.NK.cells"
"TCAGTTTGTTCGTGCG"	"Mesothelial.cells"
"TCATCCGAGGGTCAAC"	"T.NK.cells"
"TCATGAGAGAATAGTC"	"HGSOC"
"TCATGAGAGCCAAGGT"	"T.NK.cells"
"TCATGCCAGGGTACGT"	"T.NK.cells"
"TCATGGAAGGTTAAAC"	"T.NK.cells"
"TCATGGAGTTGTGGAG"	"B.cells"
"TCATGTTCAATCAGCT"	"Mesothelial.cells"
"TCATTTGGTCTACGAT"	"Myeloid.cells"
"TCCACGTAGTATTCCG"	"T.NK.cells"
"TCCAGAAAGAACCGCA"	"Fibroblasts"
"TCCATCGAGTCGCCCA"	"T.NK.cells"
"TCCGGGAAGGTTCTTG"	"HGSOC"
"TCCGTGTCATATCTGG"	"Myeloid.cells"
"TCCTTTCGTTTAAGGA"	"T.NK.cells"
"TCGACCTAGTGAATAC"	"T.NK.cells"
"TCGATTTCAATGTGGG"	"T.NK.cells"
"TCGCTCAAGTATGTAG"	"HGSOC"
"TCGGATAAGCAGCACA"	"Fibroblasts"
"TCGGATATCGCCTATC"	"Mesothelial.cells"
"TCGGTCTCAGAACGCA"	"T.NK.cells"
"TCGTCCATCGGTAACT"	"T.NK.cells"
"TCTAACTGTATCAAGA"	"Myeloid.cells"
"TCTACATTCCCGTTCA"	"HGSOC"
"TCTATACAGACATACA"	"Fibroblasts"
"TCTATACCACTATCCC"	"uncertain"
"TCTATCACATGGGTTT"	"HGSOC"
"TCTCACGGTTAAAGTG"	"T.NK.cells"
"TCTGCCAAGCAGCCCT"	"B.cells"
"TCTGCCACAATGACCT"	"HGSOC"
"TCTTAGTCAAATACGA"	"Fibroblasts"
"TCTTCCTCAGCGGTCT"	"Mast.cells"
"TCTTCCTGTCTTAGTG"	"T.NK.cells"
"TCTTCCTTCGTGGTAT"	"Mast.cells"
"TGACCCTGTGAATATG"	"HGSOC"
"TGAGCATCAATTGAAG"	"T.NK.cells"
"TGAGGAGTCGTCAAAC"	"Myeloid.cells"
"TGAGGGAAGACCAGAC"	"B.cells"
"TGATCAGTCTAGGCAT"	"HGSOC"
"TGATCTTGTCTGTTAG"	"T.NK.cells"
"TGATGCACACTTGACA"	"T.NK.cells"
"TGATGGTAGGGTAGCT"	"Mesothelial.cells"
"TGATTCTGTCATGACT"	"T.NK.cells"
"TGCACGGTCCATTTCA"	"HGSOC"
"TGCAGATAGGAATTAC"	"Fibroblasts"
"TGCATCCTCATGGGAG"	"B.cells"
"TGCCGAGTCCCTCTAG"	"Myeloid.cells"
"TGCGGCATCTCATTTG"	"B.cells"
"TGCGGGTCACCTTCGT"	"T.NK.cells"
"TGCTCGTTCCATAAGC"	"HGSOC"
"TGCTGAAGTACCAGAG"	"Mast.cells"
"TGCTTCGTCACAACCA"	"HGSOC"
"TGCTTGCAGTTGCTCA"	"Myeloid.cells"
"TGGAACTGTTATAGCC"	"HGSOC"
"TGGAGAGGTGCGACAA"	"T.NK.cells"
"TGGAGGAAGAGGTATT"	"T.NK.cells"
"TGGATCACAGAACTCT"	"T.NK.cells"
"TGGCGTGGTACTCGTA"	"HGSOC"
"TGGGAGAGTAGGTTTC"	"T.NK.cells"
"TGGGCGTGTGCGTTTA"	"T.NK.cells"
"TGGGCGTTCAACACCA"	"HGSOC"
"TGGTTAGCACAACATC"	"T.NK.cells"
"TGGTTAGCAGGCATTT"	"T.NK.cells"
"TGTAACGTCGCGATCG"	"T.NK.cells"
"TGTAGACTCTCGACCT"	"Mesothelial.cells"
"TGTCAGATCGTGTGGC"	"HGSOC"
"TGTGCGGGTGCAGGAT"	"Myeloid.cells"
"TGTGGCGTCACCCATC"	"T.NK.cells"
"TGTTCTACAGTATGAA"	"T.NK.cells"
"TGTTCTACAGTGGGTA"	"HGSOC"
"TGTTGAGGTCCTCCTA"	"T.NK.cells"
"TGTTGGATCATAGGCT"	"T.NK.cells"
"TTACAGGCAACACACT"	"HGSOC"
"TTACAGGTCGGAGATG"	"Endothelial.cells"
"TTACCGCCATCACAGT"	"T.NK.cells"
"TTACCGCTCCGCGATG"	"T.NK.cells"
"TTACGCCTCCCGTGAG"	"HGSOC"
"TTAGGCACAGCGTTGC"	"T.NK.cells"
"TTAGGGTCACTGAGGA"	"HGSOC"
"TTCACCGGTTCTCGCT"	"Myeloid.cells"
"TTCAGGACATCCTCAC"	"Myeloid.cells"
"TTCATGTTCTAACGCA"	"T.NK.cells"
"TTCATTGTCCGTATGA"	"T.NK.cells"
"TTCCAATCAGCAAGAC"	"Mesothelial.cells"
"TTCCACGCACAGCTGC"	"HGSOC"
"TTCCTAAAGCTGTTAC"	"T.NK.cells"
"TTCCTAATCGGACGTC"	"T.NK.cells"
"TTCTAGTAGCGTGTTT"	"HGSOC"
"TTCTCTCTCCAGTGTA"	"HGSOC"
"TTGACCCGTACTGAGG"	"T.NK.cells"
"TTGATGGTCGGCTCTT"	"Mast.cells"
"TTGCATTAGTCATCGT"	"T.NK.cells"
"TTGCATTGTTGCACGC"	"T.NK.cells"
"TTGCCTGCACGCTATA"	"Fibroblasts"
"TTGGATGAGCATTTCG"	"Myeloid.cells"
"TTGGGATAGGTTTACC"	"Myeloid.cells"
"TTGGGATGTTATGGTC"	"Mesothelial.cells"
"TTGGTTTAGTGGACGT"	"T.NK.cells"
"TTGTGGAGTTTCCCAC"	"HGSOC"
"TTGTTCACACGGTGAA"	"T.NK.cells"
"TTGTTGTTCAAAGAAC"	"T.NK.cells"
"TTTACGTGTTAGGCTT"	"Myeloid.cells"
"TTTCACAGTTGCATCA"	"T.NK.cells"
"TTTCACAGTTGCTCGG"	"T.NK.cells"
"TTTCGATGTCACAATC"	"HGSOC"
"TTTGACTGTGCTGCAC"	"HGSOC"
"TTTGATCAGTTCGCAT"	"T.NK.cells"
"TTTGTTGCAGGGAGAG"	"Fibroblasts"
"TTTGTTGTCGCAGTGC"	"T.NK.cells"
