barcodes	celltype_final
AAACCCATCAGCAGAG	Fibroblasts
AAACGCTCACTCCGAG	Myeloid.cells
AAAGAACCACTGTCCT	Mesothelial.cells
AACAAAGTCCGGCTTT	Mesothelial.cells
AACAACCTCGCTAAAC	Mesothelial.cells
AACAGGGAGAGGTCAC	T.NK.cells
AACCAACGTCCCTAAA	Myeloid.cells
AACCACAAGACCAAGC	T.NK.cells
AACCTTTTCACCTTGC	Fibroblasts
AACGAAATCGACGCTG	Mesothelial.cells
AACGGGAAGTAATCCC	Mesothelial.cells
AACGTCAGTTGGGCCT	Mesothelial.cells
AAGACAATCAGACTGT	Mesothelial.cells
AAGACAATCCATTTAC	T.NK.cells
AAGATAGAGTGGCAGT	Mesothelial.cells
AAGCGAGCAACTGGTT	T.NK.cells
AAGCGTTCAGCGACAA	T.NK.cells
AAGTCGTGTTGCGTAT	T.NK.cells
AAGTCGTTCCACCCTA	Fibroblasts
AAGTGAATCGTTATCT	Mesothelial.cells
AATGCCAAGCCTCAAT	Mesothelial.cells
AATGCCACATGGCACC	T.NK.cells
AATGCCATCATTGCCC	Fibroblasts
AATGGCTCAAGCCTGC	T.NK.cells
AATTCCTGTTTGAAAG	T.NK.cells
AATTTCCTCAGTGATC	T.NK.cells
ACAACCATCCTGCTAC	Myeloid.cells
ACACTGAGTAGGCTCC	T.NK.cells
ACAGCCGAGGGTTGCA	T.NK.cells
ACAGCCGGTAATTGGA	Mesothelial.cells
ACCACAATCAGACTGT	Fibroblasts
ACCACAATCGATTGAC	Myeloid.cells
ACCACAATCTCCGTGT	Mesothelial.cells
ACCCTCACAGATTCGT	B.cells
ACCTGAAGTGCGAGTA	T.NK.cells
ACGGGTCGTTAAGCAA	Mesothelial.cells
ACTACGAGTCGTTTCC	Mesothelial.cells
ACTGTGACACCGTGCA	T.NK.cells
ACTGTGACATTGACCA	Mesothelial.cells
ACTTCCGTCCGAGGCT	Fibroblasts
ACTTCGCAGCGACTTT	T.NK.cells
ACTTCGCTCGGCGATC	T.NK.cells
ACTTTCAGTTCATCTT	Myeloid.cells
AGAAGCGAGTTTCGAC	Myeloid.cells
AGAAGCGTCATGCCCT	Myeloid.cells
AGACACTTCAGGTGTT	Mesothelial.cells
AGACCCGAGCTGAGCA	Mesothelial.cells
AGACTCACACCCTCTA	T.NK.cells
AGACTCAGTAGTGATA	T.NK.cells
AGATCCATCTGAGGCC	T.NK.cells
AGATCGTGTGGTACAG	Myeloid.cells
AGATGAAGTGAATATG	T.NK.cells
AGATGCTCATGTTTGG	T.NK.cells
AGCCAGCCAACGTTAC	Mesothelial.cells
AGCCAGCGTATAGGGC	Mesothelial.cells
AGCGATTGTGCGTGCT	T.NK.cells
AGCGTCGAGGACACTG	Mesothelial.cells
AGCTCAAGTTCACGAT	T.NK.cells
AGCTTCCCACCAAAGG	Mesothelial.cells
AGCTTCCCATGACAGG	Mesothelial.cells
AGGACTTAGGCCATAG	T.NK.cells
AGGCCACCATGAAAGT	Fibroblasts
AGGCCACGTTACAGCT	Myeloid.cells
AGGGCCTCATGATGCT	Mesothelial.cells
AGGGTGACACCAAAGG	T.NK.cells
AGGTTGTGTTGTGTTG	T.NK.cells
AGGTTGTTCTTCACAT	T.NK.cells
AGTAACCAGATGCAGC	T.NK.cells
AGTACTGGTTGCATTG	T.NK.cells
AGTCAACAGGCAGCTA	Fibroblasts
AGTCAACGTTCAAACC	T.NK.cells
AGTCATGAGAGCTTTC	Mesothelial.cells
AGTGACTGTCGAACAG	T.NK.cells
AGTTCGACACAAGGTG	T.NK.cells
ATATCCTCAGGCATGA	T.NK.cells
ATCACAGAGGCTCAAG	T.NK.cells
ATCACTTTCTTGCAGA	Mesothelial.cells
ATCATTCGTGGGTCAA	T.NK.cells
ATCCGTCTCCAAGCAT	Myeloid.cells
ATCGGATTCGATGCAT	T.NK.cells
ATCTCTATCCACGTAA	T.NK.cells
ATCTTCACAGCTCGGT	T.NK.cells
ATCTTCATCGCAACAT	Mesothelial.cells
ATGCGATCAAGGTCAG	Myeloid.cells
ATGGAGGGTTCGGTCG	Fibroblasts
ATGGGTTGTCTGCATA	T.NK.cells
ATGGTTGAGCTGTACT	Myeloid.cells
ATGGTTGCACTACACA	Myeloid.cells
ATGTCCCGTGCCGAAA	Myeloid.cells
ATTACCTAGCTCTTCC	Mesothelial.cells
ATTCAGGTCTGTGCAA	Myeloid.cells
ATTCCTACATGGAATA	Mesothelial.cells
ATTCTACCAGATCCTA	Mesothelial.cells
ATTGGGTAGATAACAC	Myeloid.cells
ATTGTTCAGGCATCTT	Mesothelial.cells
ATTTACCTCTGGCTGG	T.NK.cells
CAACAACGTTGCCGCA	Mesothelial.cells
CAACGGCCACGAGGAT	Mesothelial.cells
CAAGACTCACTGAGTT	T.NK.cells
CAAGAGGGTATGTCTG	Mesothelial.cells
CAAGAGGTCGAACCTA	Myeloid.cells
CAAGCTAAGGAAGAAC	Myeloid.cells
CACAGATCATCCAACA	Mesothelial.cells
CACAGATGTGGACTAG	Fibroblasts
CACGAATCACATACGT	T.NK.cells
CACGTGGTCTACTTCA	Myeloid.cells
CACGTTCAGAGCTTTC	Fibroblasts
CACGTTCCAGCTGCCA	Mesothelial.cells
CACTGGGGTGAATTAG	Fibroblasts
CAGATCAAGCTTAGTC	Myeloid.cells
CAGCCAGGTAGCTCGC	B.cells
CAGGGCTTCTGAGAGG	Myeloid.cells
CAGGTATCAACGCATT	T.NK.cells
CATACAGCACCTGATA	Myeloid.cells
CATACCCAGCCTCATA	Myeloid.cells
CATAGACCATGACCCG	Myeloid.cells
CATCAAGTCGTTAGTG	Mesothelial.cells
CATCCACAGCCTGCCA	Mesothelial.cells
CATCCACGTACTCAAC	Mesothelial.cells
CATCGCTGTTATTCTC	Mesothelial.cells
CATCGCTTCCATTGGA	T.NK.cells
CATCGGGTCTGCTCTG	T.NK.cells
CATGCCTCAATGCTCA	T.NK.cells
CATGCGGCACAACATC	Endothelial.cells
CATTCATTCACCGACG	B.cells
CATTCTAGTACAAGCG	Mesothelial.cells
CATTCTAGTCAACATC	Mesothelial.cells
CATTGCCGTGTCTCCT	Myeloid.cells
CATTGTTAGCTATCCA	T.NK.cells
CATTGTTTCGAGAAGC	T.NK.cells
CATTTCAAGAGAAGGT	T.NK.cells
CCAAGCGCATCCGCGA	T.NK.cells
CCAAGCGTCCATTGCC	Fibroblasts
CCAATGAGTGAGACGT	Mesothelial.cells
CCAATTTCAGCAGGAT	Mesothelial.cells
CCATCACAGTATAGGT	Mesothelial.cells
CCGATGGAGTTAACAG	T.NK.cells
CCGGTAGGTTAAGAAC	Mesothelial.cells
CCGTTCATCGCCTCTA	T.NK.cells
CCTACGTCAGTGACCC	T.NK.cells
CCTCAACCAGAGTAAT	Myeloid.cells
CCTCAACGTATCCTCC	T.NK.cells
CCTCCTCAGCTATCTG	T.NK.cells
CCTCTCCGTCATAACC	Endothelial.cells
CCTTCAGAGAATTGTG	Mesothelial.cells
CGAAGTTTCGCGGTAC	Fibroblasts
CGAATTGTCTTCTCAA	T.NK.cells
CGAGGAACAATAGTCC	T.NK.cells
CGATGGCTCCGAGTGC	T.NK.cells
CGCCAGACACGATAGG	T.NK.cells
CGGAACCTCCGCACGA	Myeloid.cells
CGGAATTCAAACTCGT	T.NK.cells
CGGAGAACACTGCACG	Mesothelial.cells
CGGCAGTGTGGTCTAT	T.NK.cells
CGGTCAGCATGGCCAC	Mesothelial.cells
CGTAATGCAATCTCTT	Mesothelial.cells
CGTAGTATCAAGTGGG	Mesothelial.cells
CGTCAAATCCCGATCT	T.NK.cells
CGTTCTGTCAACTGGT	Myeloid.cells
CTACCCACATCGAAGG	T.NK.cells
CTACCTGCAACACAGG	Myeloid.cells
CTCACTGTCTTCCCAG	Mesothelial.cells
CTCATCGCACACCTTC	Mesothelial.cells
CTCCACAGTTTCAGAC	Myeloid.cells
CTCCATGCAGGACTTT	Myeloid.cells
CTCCCTCCAGGTTCCG	T.NK.cells
CTCCTCCCACTGGATT	T.NK.cells
CTCTGGTAGATCGCTT	Mesothelial.cells
CTGAGCGGTCGTGGTC	Fibroblasts
CTGAGCGGTGTCGATT	T.NK.cells
CTGATCCGTTGGATCT	T.NK.cells
CTGATCCTCCTGTTAT	Mesothelial.cells
CTGCAGGCAGAGATTA	Mesothelial.cells
CTGCAGGTCTTCGACC	T.NK.cells
CTGCCTAAGCTGCCAC	Mesothelial.cells
CTGGACGAGCGCATCC	T.NK.cells
CTGGACGGTCACTTAG	Myeloid.cells
CTGGCAGGTGAATGTA	T.NK.cells
CTGTCGTGTCAAAGAT	Mesothelial.cells
CTGTGAACAGTTGTTG	Mesothelial.cells
CTGTGAATCACGATCA	T.NK.cells
CTGTGGGCAGACACCC	Mesothelial.cells
CTTCCGATCTGGAGAG	T.NK.cells
CTTCTCTGTTCAAGGG	T.NK.cells
CTTTCAATCTCTCAAT	Mesothelial.cells
GAAATGACACTGTTCC	Fibroblasts
GAAATGAGTGCGAACA	T.NK.cells
GAAGGACCAAGGGCAT	Mesothelial.cells
GAAGGACGTATGGAAT	Mesothelial.cells
GAAGGACTCGAGCTGC	Mesothelial.cells
GAATCACCACTCACTC	T.NK.cells
GAATCACCAGCTACCG	Mesothelial.cells
GACACGCGTCTGTGAT	Mesothelial.cells
GACATCATCAACGCTA	T.NK.cells
GACGTTAGTTCAGCGC	Myeloid.cells
GACTCTCAGGTCACCC	T.NK.cells
GACTCTCTCATTACCT	T.NK.cells
GAGACCCAGGTAGTAT	Fibroblasts
GAGGCAAGTATTTCGG	Mesothelial.cells
GAGGCAAGTTAGTTCG	T.NK.cells
GAGGCCTGTAGAGACC	Mesothelial.cells
GAGGGTACAACTGCCG	Myeloid.cells
GAGTGAGTCGATTGGT	Myeloid.cells
GATAGCTTCGCTGCGA	Fibroblasts
GATCATGTCATGCCAA	T.NK.cells
GATCCCTAGAATTGTG	Fibroblasts
GATCGTATCCACTTTA	Fibroblasts
GATGGAGCAGCAGTGA	Mesothelial.cells
GATGGAGTCCAACTGA	T.NK.cells
GATTGGTTCGATCCCT	Mesothelial.cells
GATTTCTCAAGCACCC	T.NK.cells
GATTTCTGTCACGTGC	Mesothelial.cells
GCACATATCGAGAAAT	Mesothelial.cells
GCACGGTTCTGGGCGT	T.NK.cells
GCACTAAGTTAATCGC	T.NK.cells
GCAGGCTTCTCTTGCG	Myeloid.cells
GCAGTTACAAGGCGTA	Fibroblasts
GCATCGGAGGGTACAC	Mesothelial.cells
GCATCGGGTAGTCACT	Myeloid.cells
GCATCTCAGGGTTAGC	Fibroblasts
GCATCTCAGTCGCCAC	Mesothelial.cells
GCATTAGTCATAGCAC	Fibroblasts
GCCAACGCACAACATC	T.NK.cells
GCCAGGTTCTCCGATC	T.NK.cells
GCCATGGCAATAACGA	T.NK.cells
GCCATTCGTAAGCAAT	T.NK.cells
GCCCGAAGTGAGGAAA	T.NK.cells
GCCCGAAGTGTGTACT	T.NK.cells
GCGAGAACATCAGTGT	Mesothelial.cells
GCGATCGAGGCAGTCA	Mesothelial.cells
GCGATCGCACCACTGG	Myeloid.cells
GCGATCGTCCATAAGC	Mesothelial.cells
GCGGATCAGGGCAATC	Mesothelial.cells
GCTACAATCGGTCTAA	Mesothelial.cells
GCTGAATAGTTCCTGA	Mesothelial.cells
GCTTCACTCCTTCTTC	T.NK.cells
GGAATCTAGCATTTCG	T.NK.cells
GGAATCTAGCGGATCA	Mesothelial.cells
GGACGTCAGATGGTCG	T.NK.cells
GGAGAACAGAGGTCGT	T.NK.cells
GGAGAACTCTCAACCC	T.NK.cells
GGAGATGGTTCGAACT	Mesothelial.cells
GGAGCAAAGCTGAGCA	T.NK.cells
GGAGCAACACCTGCGA	Mesothelial.cells
GGATCTATCCGTTGAA	Mesothelial.cells
GGCGTCAAGTGATTCC	T.NK.cells
GGCTGTGCAGGACTTT	T.NK.cells
GGGTGTCCAGGTCAGA	T.NK.cells
GGTAACTCATCGTGCG	Mesothelial.cells
GGTAACTCATGAGGGT	T.NK.cells
GGTAACTTCGCGTAGC	T.NK.cells
GGTAGAGAGCGTTAGG	T.NK.cells
GGTCTGGTCTGGAAGG	Mesothelial.cells
GGTGATTAGTTGCGCC	Mesothelial.cells
GGTGGCTCACTTGACA	T.NK.cells
GGTTCTCGTAGCTTGT	Mesothelial.cells
GGTTGTAAGCGAGTCA	Myeloid.cells
GTAACACCAAGATGGC	Mesothelial.cells
GTAGAGGCACAGAAGC	T.NK.cells
GTAGATCAGACTCGAG	T.NK.cells
GTAGGTTAGGCGTTGA	Myeloid.cells
GTAGTACTCTTCGTGC	T.NK.cells
GTCAAGTAGTACTCGT	Fibroblasts
GTCACGGGTTCTTGCC	Myeloid.cells
GTCACTCTCTTCACAT	Myeloid.cells
GTCAGCGAGATACATG	T.NK.cells
GTCATCCGTTGAATCC	Myeloid.cells
GTCATTTAGACCATTC	Fibroblasts
GTCATTTAGTAGCCAG	Myeloid.cells
GTCCACTTCACATACG	Mesothelial.cells
GTCGCGACAAATCCCA	Myeloid.cells
GTCTACCTCAAATGAG	Myeloid.cells
GTCTCACTCTCATAGG	Mesothelial.cells
GTGAGCCCAGTCGGAA	T.NK.cells
GTGATGTCAAAGGCTG	T.NK.cells
GTGCTTCAGGAAGTCC	Mesothelial.cells
GTGCTTCGTAGCGTCC	Fibroblasts
GTGGAGACAGGAATAT	Myeloid.cells
GTGGGAAGTCGCCACA	Mesothelial.cells
GTGGTTACACGACAAG	Mesothelial.cells
GTGGTTAGTGTCCGTG	T.NK.cells
GTGTTCCCAATTTCCT	Mesothelial.cells
GTGTTCCCATACAGCT	Myeloid.cells
GTTACAGTCGTCAGAT	Mesothelial.cells
GTTACCCTCTATTGTC	Mesothelial.cells
GTTAGTGGTTATAGCC	T.NK.cells
GTTATGGCAGAGGTTG	T.NK.cells
GTTTGGACATCGATAC	Mesothelial.cells
TAACACGTCAGTAGGG	Myeloid.cells
TAAGCACGTCCAGCAC	Myeloid.cells
TAAGCACGTCTCACGG	T.NK.cells
TAAGCCACATGGGAAC	T.NK.cells
TAAGCGTGTGAGACGT	Mesothelial.cells
TAAGTCGGTCTCACGG	Myeloid.cells
TAAGTCGGTGAATTAG	Myeloid.cells
TACAACGTCACCGCTT	Myeloid.cells
TACAGGTCACTGCATA	T.NK.cells
TACATTCCAAGAGATT	Mesothelial.cells
TACCGAAAGACTACCT	T.NK.cells
TACCGGGTCGGTAAGG	Myeloid.cells
TACGGTAAGCCTCGTG	T.NK.cells
TACTTACTCGGACAAG	T.NK.cells
TACTTGTTCTTGATTC	Fibroblasts
TAGACCATCCTTCTAA	Mesothelial.cells
TAGTGCACATTCACAG	T.NK.cells
TATACCTGTTGGCCGT	Mesothelial.cells
TATCAGGCACTAACGT	T.NK.cells
TATCAGGGTCATAACC	T.NK.cells
TATCCTAGTTACGTAC	T.NK.cells
TATCGCCTCGAACGCC	T.NK.cells
TATCTGTGTCACTCGG	T.NK.cells
TATCTGTTCCATCCGT	Mesothelial.cells
TATCTTGGTGACGTCC	Myeloid.cells
TATGTTCAGGACGCTA	Mesothelial.cells
TATTCCAAGCGTCTCG	T.NK.cells
TCAATCTGTTCTCGCT	T.NK.cells
TCACAAGAGGTTACCT	T.NK.cells
TCACGGGTCTACCAGA	Fibroblasts
TCACTCGGTTAGAGTA	Mesothelial.cells
TCAGCCTTCATTACCT	Mesothelial.cells
TCAGGTAGTAGCGCCT	Mesothelial.cells
TCAGTGAAGTAGGTTA	Myeloid.cells
TCATATCTCTGAGCAT	T.NK.cells
TCATCATTCCACGGAC	Myeloid.cells
TCATGCCTCTTAGGAC	T.NK.cells
TCATTCAGTCATCGCG	T.NK.cells
TCCACCATCACCCTCA	Myeloid.cells
TCCACGTCAAGATCCT	T.NK.cells
TCCACGTCAGCGTGCT	Fibroblasts
TCCAGAACAGCGACCT	Myeloid.cells
TCCATGCCACGTAGAG	T.NK.cells
TCCTAATAGCAGTACG	T.NK.cells
TCCTCGAGTGGGCTTC	T.NK.cells
TCCTCTTTCTGTCGTC	T.NK.cells
TCCTCTTTCTTGCAAG	T.NK.cells
TCCTTCTGTAAGCGGT	T.NK.cells
TCGAACAGTCCGGTCA	Myeloid.cells
TCGAAGTTCACCTTAT	Myeloid.cells
TCGCACTTCACCCATC	Myeloid.cells
TCGCTCATCATTGAGC	Mesothelial.cells
TCGGGACAGGTTCCGC	Fibroblasts
TCGGGACCAGAAGCGT	T.NK.cells
TCGTGCTCATCCGAGC	T.NK.cells
TCTCCGAGTCCAAATC	T.NK.cells
TCTCCGAGTGGCCCAT	Mesothelial.cells
TCTGGCTAGACAACTA	T.NK.cells
TCTTAGTGTGGCGTAA	Fibroblasts
TGAACGTGTCTTCAAG	Endothelial.cells
TGAATCGAGCAAATGT	Mesothelial.cells
TGAATCGTCTGAATGC	Fibroblasts
TGAGCATCAGTCTACA	T.NK.cells
TGAGGGAGTACGAGTG	T.NK.cells
TGAGGTTCATCCTTCG	Myeloid.cells
TGATGCACAGATTCGT	Mesothelial.cells
TGCGACGCAATTCGTG	Mesothelial.cells
TGCGACGCAGACTGCC	Fibroblasts
TGCGGGTAGACCCGCT	Mesothelial.cells
TGCGGGTGTGCCCACA	T.NK.cells
TGCTCGTCATGTGACT	Myeloid.cells
TGCTCGTCATTCGGGC	T.NK.cells
TGGAGAGAGTGGAAAG	Fibroblasts
TGGCGTGCAGACAAGC	Mesothelial.cells
TGGGAGAAGTCTACCA	Mesothelial.cells
TGGGATTCAGGTCTCG	Fibroblasts
TGGGCTGCACAGTACT	Mesothelial.cells
TGGTACAGTACAGTTC	Mesothelial.cells
TGGTAGTAGTGCGCTC	Fibroblasts
TGGTTAGGTACGTGTT	T.NK.cells
TGTAACGTCCAATCCC	T.NK.cells
TGTACAGAGATACCAA	Fibroblasts
TGTGCGGGTCTATGAC	Mesothelial.cells
TGTGCGGGTGATACAA	T.NK.cells
TGTGGCGCATTACGGT	Mesothelial.cells
TGTGGCGTCCGTCACT	Myeloid.cells
TGTTCATAGCTAATGA	Mesothelial.cells
TGTTGGACACTATCGA	Mesothelial.cells
TGTTGGAGTAGTATAG	Myeloid.cells
TTAATCCGTCACAGTT	Myeloid.cells
TTACGCCAGAGAGTTT	Myeloid.cells
TTACTGTAGTAAATGC	T.NK.cells
TTAGGCAGTCCATAGT	T.NK.cells
TTAGGCAGTCGAATGG	Mesothelial.cells
TTAGGGTGTCATGACT	T.NK.cells
TTAGTCTTCAACTGGT	Fibroblasts
TTATTGCGTCGAAACG	T.NK.cells
TTCAGGAAGCCGCTTG	Mesothelial.cells
TTCCAATAGATCGCTT	Myeloid.cells
TTCCTAAGTCAAGGCA	Mesothelial.cells
TTCCTCTCACATAACC	T.NK.cells
TTCGCTGAGACTACCT	Fibroblasts
TTCGCTGGTTAAGAAC	T.NK.cells
TTCTCTCGTACCACGC	T.NK.cells
TTCTTGATCTTCTAAC	T.NK.cells
TTGACCCTCCTTACCG	Fibroblasts
TTGAGTGGTCACGCTG	Mesothelial.cells
TTGATGGCAGTCAGTT	T.NK.cells
TTGCCTGTCAACCTTT	T.NK.cells
TTGCGTCAGTAGAGTT	Fibroblasts
TTGCTGCTCCGCAAAT	Mesothelial.cells
TTGCTGCTCGTACCTC	Myeloid.cells
TTGGGATGTTCCACAA	T.NK.cells
TTGGTTTAGCCTAGGA	Fibroblasts
TTGGTTTTCCGTAGGC	Mesothelial.cells
TTGTTCAGTCGTACTA	Fibroblasts
TTGTTGTCACACGGAA	Mesothelial.cells
TTGTTGTGTAGTTAGA	T.NK.cells
TTGTTGTTCATCGCAA	T.NK.cells
TTTACGTAGAGTGAAG	Mesothelial.cells
TTTCAGTCAAGACGAC	Mesothelial.cells
TTTCAGTGTGCCCTTT	Fibroblasts
TTTCATGCATGTCGTA	T.NK.cells
TTTCCTCGTAAGATAC	Mesothelial.cells
TTTGACTGTTACCGTA	Fibroblasts
TTTGACTTCCGTGGGT	T.NK.cells
TTTGGTTTCTTCCAGC	T.NK.cells
