barcodes	celltype_final
AAACCCAGTCGAGCTC	T.NK.cells
AAACGAACAGTAACGG	Fibroblasts
AAAGAACGTACGTAGG	Mesothelial.cells
AAAGGATCACAATCTG	Mesothelial.cells
AAAGTCCCAGTTGCGC	Fibroblasts
AAAGTGAGTCCTATAG	Mesothelial.cells
AAATGGAGTTCAAACC	T.NK.cells
AACAAAGGTCCCTGTT	Mesothelial.cells
AACAACCAGGCTTAGG	T.NK.cells
AACAACCGTCCTCCTA	T.NK.cells
AACAACCTCTGGGCGT	Mesothelial.cells
AACAAGATCGAGTTGT	Mesothelial.cells
AACACACGTCGAATTC	Mesothelial.cells
AACCAACAGGAAACGA	Mesothelial.cells
AACCTGAAGATACAGT	Mesothelial.cells
AACCTTTAGAGTCTGG	Mesothelial.cells
AACCTTTAGGCTGAAC	Mesothelial.cells
AACGGGAGTGTCATGT	Mesothelial.cells
AACGGGATCATTATCC	Mesothelial.cells
AAGAACACAATTCTCT	Mesothelial.cells
AAGACTCAGACATCCT	Fibroblasts
AAGACTCCAGCTCGGT	T.NK.cells
AAGACTCGTTGGAGAC	Mesothelial.cells
AAGATAGCAGACCTGC	Endothelial.cells
AAGCATCCATGACAAA	Mesothelial.cells
AAGCATCGTCATGGCC	Fibroblasts
AAGCGAGTCCATGAGT	Fibroblasts
AAGGAATAGCAAATCA	Mesothelial.cells
AAGGAATAGCGAGGAG	Fibroblasts
AAGGAATAGGGTTAGC	T.NK.cells
AAGGTAAGTACATACC	Mesothelial.cells
AATCGACTCCACGGGT	Fibroblasts
AATGAAGGTGCGAGTA	Mesothelial.cells
AATGACCAGATAGCTA	Mesothelial.cells
AATGGCTCAACTTGGT	Fibroblasts
AATGGCTGTCGAGATG	T.NK.cells
AATTTCCAGCATTGAA	T.NK.cells
ACAACCACAGTTCCAA	Mesothelial.cells
ACAAGCTAGCTGAAGC	Mesothelial.cells
ACACAGTTCAACCTTT	Mesothelial.cells
ACACTGAAGATGGTCG	Mesothelial.cells
ACACTGACATGTGGTT	Mesothelial.cells
ACAGAAAGTCCGGTGT	Mesothelial.cells
ACAGAAATCATGCCCT	Mesothelial.cells
ACATCCCTCGGCTGTG	Mesothelial.cells
ACATGCACAGGCCTGT	Fibroblasts
ACCACAATCCGTAGGC	Mesothelial.cells
ACCATTTCAGGTTTAC	Mesothelial.cells
ACCCAAAAGTCATTGC	Mesothelial.cells
ACCCAAAAGTGCAGCA	Fibroblasts
ACCCTTGAGAGCGACT	Mesothelial.cells
ACCTACCGTGCGTCGT	Mesothelial.cells
ACCTACCGTTCGTAAC	Fibroblasts
ACCTGAAAGCTTTGTG	Mesothelial.cells
ACGATCAAGGTCGTGA	Mesothelial.cells
ACGATGTGTGGACTGA	Myeloid.cells
ACGGAAGCAACCACAT	Mesothelial.cells
ACGGTCGCATTGTAGC	Myeloid.cells
ACGGTCGTCGAATCCA	Mesothelial.cells
ACGGTTAAGTTGCTCA	Myeloid.cells
ACGGTTAGTCAGGCAA	Fibroblasts
ACGTAGTTCACATCAG	Mesothelial.cells
ACGTTCCCACGTCGTG	Mesothelial.cells
ACTATCTTCGCGGACT	Fibroblasts
ACTCTCGGTGCATCTA	Fibroblasts
ACTCTCGTCAGACCTA	Fibroblasts
ACTCTCGTCTCTTAAC	Fibroblasts
ACTGATGTCTCCCTAG	Fibroblasts
ACTGCAACAATCCTAG	T.NK.cells
ACTGCAAGTGTCCGGT	Mesothelial.cells
ACTGTCCCAAAGGCTG	Mesothelial.cells
ACTGTCCGTGAGTTTC	Fibroblasts
ACTTAGGAGCGCCCAT	T.NK.cells
ACTTATCCAGCAGAAC	Mesothelial.cells
ACTTCCGTCGTGGACC	T.NK.cells
AGAAATGGTCAGTTTG	Mesothelial.cells
AGAAGCGGTACAGAAT	Fibroblasts
AGAAGCGTCTCACCCA	Mesothelial.cells
AGACAAATCGATTTCT	Mesothelial.cells
AGACCCGCAGTGCCTG	T.NK.cells
AGAGCAGCACCCAATA	Mesothelial.cells
AGAGCCCGTCAGTTTG	Mesothelial.cells
AGAGCCCGTCATGACT	T.NK.cells
AGATAGATCGCACTCT	Mesothelial.cells
AGATCCATCGTCGATA	Mesothelial.cells
AGATGAACAATCGTCA	Fibroblasts
AGATGAATCTGAGCAT	Fibroblasts
AGCATCAAGACCGCCT	Mesothelial.cells
AGCCAATGTCTTGCGG	Mesothelial.cells
AGCCACGAGGTGATAT	Fibroblasts
AGCCAGCCAAGAATAC	Mesothelial.cells
AGCGATTTCTCAACGA	Fibroblasts
AGCGTATGTATAGGGC	Fibroblasts
AGCTACATCACGAACT	T.NK.cells
AGCTCAAGTTTGGAAA	Mesothelial.cells
AGGAAATAGAGACAAG	Mesothelial.cells
AGGCATTAGAGTGGCT	Fibroblasts
AGGCCACAGGACAAGA	Mesothelial.cells
AGGCCACCACCCTTGT	Mesothelial.cells
AGGCCACCAGGAACCA	Mesothelial.cells
AGGCCACGTACGCTTA	T.NK.cells
AGGCTGCAGGTGCGAT	T.NK.cells
AGGGAGTAGGTCCAGA	Fibroblasts
AGGGAGTGTCCGCAGT	Mesothelial.cells
AGGGCCTAGTCATCCA	Mesothelial.cells
AGGGTTTAGGTGGTTG	Mesothelial.cells
AGGTTACGTCGGAAAC	T.NK.cells
AGGTTACGTTGGGTTT	Mesothelial.cells
AGTACCAAGTTCGGTT	Mesothelial.cells
AGTAGTCCACTGAATC	Fibroblasts
AGTAGTCGTCTGTAGT	Mesothelial.cells
AGTCACAGTCCTGAAT	Mesothelial.cells
AGTCATGGTTACGTAC	Mesothelial.cells
AGTGATCTCGGCTTGG	Mesothelial.cells
AGTGCCGTCACGGGAA	Endothelial.cells
ATACCGATCTTCCGTG	Mesothelial.cells
ATACCTTGTTGGCCTG	Mesothelial.cells
ATAGAGAAGCCTATCA	Mesothelial.cells
ATAGGCTCAGAAATCA	T.NK.cells
ATCACAGCATCTGCGG	Mesothelial.cells
ATCCATTGTGAGAGGG	Myeloid.cells
ATCCTATAGCTAGCCC	Mesothelial.cells
ATCGATGAGAGCATCG	Endothelial.cells
ATCGGATCACCTCGTT	Mesothelial.cells
ATCGGATTCAAGGCTT	Mesothelial.cells
ATCGTAGTCGACGCGT	Mesothelial.cells
ATGACCATCCATATGG	Fibroblasts
ATGAGGGAGAATCGCG	Fibroblasts
ATGATCGCATGTGACT	Fibroblasts
ATGCGATCAACGGCTC	Mesothelial.cells
ATGGAGGCAGGACGAT	T.NK.cells
ATGGGAGAGGATTTAG	Mesothelial.cells
ATGGGAGAGGTCTGGA	Mesothelial.cells
ATTCATCGTCAGCGTC	T.NK.cells
ATTCATCGTTAGGCCC	Fibroblasts
ATTCCATAGCACTTTG	Mesothelial.cells
ATTCCTATCCAGTTCC	Fibroblasts
ATTCTACAGATTCGAA	Mesothelial.cells
ATTGGGTAGATCCCGC	Mesothelial.cells
ATTGGGTGTCAGTCCG	T.NK.cells
ATTGGGTTCCCGAGAC	T.NK.cells
ATTTACCCATGCACTA	T.NK.cells
CAAAGAACACCAACAT	Fibroblasts
CAAAGAATCAACTTTC	Mesothelial.cells
CAACCTCTCGGATTAC	Mesothelial.cells
CAACGATAGACTGGGT	Mesothelial.cells
CAACGATGTCCACGCA	T.NK.cells
CAAGCTAAGACATCAA	Mesothelial.cells
CAAGGGATCGGCATAT	Fibroblasts
CAATCGAAGGAGGCAG	Mesothelial.cells
CAATGACGTTACGATC	Fibroblasts
CACAACATCTCACCCA	Mesothelial.cells
CACACAACAACTTCTT	Mesothelial.cells
CACACAACATGCCATA	Mesothelial.cells
CACAGGCCAGTCGCAC	Fibroblasts
CACAGGCTCATCTACT	T.NK.cells
CACATGATCCCATGGG	Mesothelial.cells
CACCGTTCATCCAATG	Fibroblasts
CACCGTTTCACTTGGA	T.NK.cells
CACGAATCAAGCTGTT	Fibroblasts
CACGTGGAGGCGAACT	Mesothelial.cells
CACGTGGCATGATGCT	Fibroblasts
CACTGTCCATGACAAA	Mesothelial.cells
CACTTCGTCCTCACCA	Fibroblasts
CAGATCATCTACACAG	T.NK.cells
CAGCAATTCGGTAGGA	Mesothelial.cells
CAGGGCTCAGCGCGTT	T.NK.cells
CAGTGCGTCTGCATAG	Fibroblasts
CAGTTAGGTTTAAGGA	Mesothelial.cells
CATAAGCTCTGCTTTA	T.NK.cells
CATCAAGGTGATGAAT	Mesothelial.cells
CATCCGTCATCATTTC	Mesothelial.cells
CATCGTCGTCATCCGG	Mesothelial.cells
CATGAGTGTGTATTGC	Mesothelial.cells
CATGCCTGTTTGTTCT	Mesothelial.cells
CATGCGGGTACCAGAG	Mesothelial.cells
CATGCTCTCAGGAGAC	Mesothelial.cells
CATGCTCTCGTTCCCA	T.NK.cells
CATGGATCAAGTGGAC	Fibroblasts
CATGGATTCATGCGGC	Mesothelial.cells
CATTCCGAGTAAGGGA	T.NK.cells
CATTTCATCGATACGT	T.NK.cells
CCAAGCGTCTTCCTAA	Fibroblasts
CCACGAGCATAATCGC	T.NK.cells
CCACGAGCATCAGTCA	T.NK.cells
CCACGTTTCTGGTGCG	Myeloid.cells
CCACTTGAGCGAGAAA	T.NK.cells
CCATCACCATGACTGT	T.NK.cells
CCATCACCATGGGAAC	T.NK.cells
CCCAACTGTTCGGTTA	Mesothelial.cells
CCCTAACCACGCTATA	Mesothelial.cells
CCCTGATCAATCTGCA	Fibroblasts
CCCTTAGCATGGCACC	T.NK.cells
CCGATCTAGATCCTAC	Mesothelial.cells
CCGATCTGTAAGCTCT	Myeloid.cells
CCGCAAGGTGATACTC	Fibroblasts
CCGCAAGTCTCTGACC	Myeloid.cells
CCGGTAGGTGAATAAC	Mesothelial.cells
CCGTAGGGTGCGCTCA	Mesothelial.cells
CCGTGAGTCTCGGTAA	Fibroblasts
CCGTTCAGTGCCGTTG	Fibroblasts
CCTAACCCAATAGAGT	Mesothelial.cells
CCTAAGACAAATCGTC	Mesothelial.cells
CCTATCGGTAACCCGC	T.NK.cells
CCTATCGGTCTGATCA	T.NK.cells
CCTGCATCACGGTCTG	Fibroblasts
CCTGTTGTCTGCTCTG	T.NK.cells
CCTTCAGAGAAGCGCT	T.NK.cells
CCTTCAGAGTTGCGCC	Fibroblasts
CCTTGTGAGTTCATCG	T.NK.cells
CCTTGTGTCGACGTCG	Mesothelial.cells
CGAAGGAAGGAAACGA	T.NK.cells
CGAAGTTGTCGCTGCA	Mesothelial.cells
CGACAGCAGTATGAAC	Mesothelial.cells
CGAGTGCAGGCACGAT	Mesothelial.cells
CGATGGCCAAAGCACG	Fibroblasts
CGCATAACATAATGAG	Mesothelial.cells
CGCATGGTCATTCTTG	Mesothelial.cells
CGCATGGTCGAAGCAG	T.NK.cells
CGCCATTTCCGTTTCG	Mesothelial.cells
CGGAACCCACTCACTC	Mesothelial.cells
CGGGTGTCATTGAGGG	Mesothelial.cells
CGGTCAGAGACGGTTG	Mesothelial.cells
CGTAATGAGAAATGGG	T.NK.cells
CGTAATGAGAAGGCTC	Mesothelial.cells
CGTAATGCACATTCTT	T.NK.cells
CGTAGTAGTCTTACTT	T.NK.cells
CGTCAAATCGCGCCAA	Fibroblasts
CGTCCATCATACTTTC	Mesothelial.cells
CGTGATACACGCTGAC	Mesothelial.cells
CGTTCTGCACTTGTGA	T.NK.cells
CTAAGTGTCGTGTGGC	Mesothelial.cells
CTACAGAGTTCTAACG	Mesothelial.cells
CTACAGATCGATGGAG	Mesothelial.cells
CTACCCAAGAGGACTC	Myeloid.cells
CTACCCACACTTACAG	T.NK.cells
CTACCTGTCTCATTGT	Mesothelial.cells
CTACCTGTCTTGGCTC	Mesothelial.cells
CTACGGGAGATTGTGA	Fibroblasts
CTACTATTCGATCCAA	Mesothelial.cells
CTATAGGGTGTGGACA	T.NK.cells
CTATCCGTCAATCGGT	Mesothelial.cells
CTATCTAGTAGGTAGC	Mesothelial.cells
CTATCTAGTGTAAATG	Mesothelial.cells
CTCAACCCATCCGATA	Mesothelial.cells
CTCAACCTCCTAAACG	Myeloid.cells
CTCACTGGTTAGGACG	Mesothelial.cells
CTCAGGGCACCGTACG	Mesothelial.cells
CTCAGTCGTTATCTGG	Fibroblasts
CTCAGTCTCCAAGAGG	Mesothelial.cells
CTCCACAGTTGCATTG	Fibroblasts
CTCCCAAAGTACAGAT	Mesothelial.cells
CTCCCAATCTAAGGAA	Fibroblasts
CTCCCTCAGCTACGTT	Mesothelial.cells
CTCCCTCTCTTCGATT	Mesothelial.cells
CTCGAGGTCGAAATCC	Mesothelial.cells
CTCTCGAGTAGGTCAG	Mesothelial.cells
CTCTGGTGTCTCGGGT	Mesothelial.cells
CTCTGGTGTTCAGGTT	T.NK.cells
CTGAATGTCCAACCGG	Mesothelial.cells
CTGAATGTCCACACAA	Mesothelial.cells
CTGAGCGCATTGTACG	Mesothelial.cells
CTGAGGCTCGACCCAG	Mesothelial.cells
CTGATCCGTACTTCCC	Mesothelial.cells
CTGCATCGTATCAAGA	Mesothelial.cells
CTGCCATGTGGCTTAT	Mesothelial.cells
CTGCCTACAGTCAGAG	Mesothelial.cells
CTGGTCTGTATAGGAT	Mesothelial.cells
CTGTGAAAGGCTGTAG	Mesothelial.cells
CTTACCGTCAGACCGC	Mesothelial.cells
CTTAGGATCTAGTCAG	Mesothelial.cells
CTTCAATAGGTTGACG	Mesothelial.cells
CTTGAGAAGAAGTCTA	Mesothelial.cells
CTTGAGATCGCCTAGG	Mesothelial.cells
GAAACCTCACAGTGTT	Mesothelial.cells
GAAATGAGTGTTCGTA	Mesothelial.cells
GAACACTAGGGTGGGA	Fibroblasts
GAACACTAGGTGAGCT	Mesothelial.cells
GAACACTGTCTAACTG	Mesothelial.cells
GAACGTTTCACAAGGG	T.NK.cells
GAAGAATAGTCTTCGA	Myeloid.cells
GAAGGACGTAGCTAAA	Fibroblasts
GAAGGACTCGTTCTAT	Mesothelial.cells
GAAGGGTAGTCTAGCT	Mesothelial.cells
GAAGGGTGTGGTCTTA	Mesothelial.cells
GAAGGGTGTTAAGTCC	T.NK.cells
GAAGTAACACATGTTG	Mesothelial.cells
GAAGTAACAGAAGTTA	Mesothelial.cells
GAATCACAGTCCGCCA	Mesothelial.cells
GACAGCCCAAACTCGT	Fibroblasts
GACATCACAAATGGCG	Mesothelial.cells
GACATCACAATGCAAA	Mesothelial.cells
GACATCACAGCTGAGA	T.NK.cells
GACATCAGTATCCCTC	T.NK.cells
GACCCTTCAGGTATGG	Mesothelial.cells
GACCGTGAGGCCTGAA	Endothelial.cells
GACGCTGTCTAGTCAG	Mesothelial.cells
GACGTTACACCATATG	Myeloid.cells
GACGTTATCTCTATAC	Mesothelial.cells
GACTATGAGACTCTTG	Mesothelial.cells
GACTCAAAGCACGGAT	Mesothelial.cells
GACTTCCCATCCGATA	Fibroblasts
GAGAAATCATAGCACT	Mesothelial.cells
GAGACTTAGACGACGT	Mesothelial.cells
GAGACTTAGGCCTGAA	Mesothelial.cells
GAGATGGCAGGATGAC	Mesothelial.cells
GAGGCAAAGTGCACTT	T.NK.cells
GAGGCAAGTCTTGAAC	Mesothelial.cells
GAGGCCTGTAGATTGA	Mesothelial.cells
GAGGGATAGCTGCCAC	Mesothelial.cells
GAGGGATGTCACATTG	Myeloid.cells
GAGGGATGTCCGGCAT	Fibroblasts
GAGTCATAGCGAGGAG	Fibroblasts
GAGTGAGCAACCGCCA	Mesothelial.cells
GAGTTTGTCAAGCCTA	Mesothelial.cells
GATAGAACACTACCCT	T.NK.cells
GATCACACATGGCACC	Myeloid.cells
GATCACAGTAACTTCG	Fibroblasts
GATGATCTCGCCTTGT	Fibroblasts
GATGATCTCTGAGAAA	Fibroblasts
GATGGAGCAAATGCGG	Mesothelial.cells
GATTCTTTCAAGGTGG	Mesothelial.cells
GATTCTTTCCCGAACG	T.NK.cells
GATTGGTTCCATTCAT	Mesothelial.cells
GCACATATCTTCGACC	Mesothelial.cells
GCACGGTAGCTTACGT	Fibroblasts
GCAGCCAAGATGCTGG	Mesothelial.cells
GCAGCTGTCAATGCAC	Mesothelial.cells
GCAGGCTGTCGAAGCA	T.NK.cells
GCATCGGAGCTTGTTG	Fibroblasts
GCCAACGCAAGGCGTA	T.NK.cells
GCCAGCACAACGACTT	Mesothelial.cells
GCCAGCACACTATCGA	T.NK.cells
GCCAGTGTCTTCGTGC	Mesothelial.cells
GCCCGAAAGACATATG	T.NK.cells
GCCGATGAGTCAGAGC	Fibroblasts
GCCTGTTGTGTACAGG	Mesothelial.cells
GCGGAAAGTGTTGCCG	Fibroblasts
GCGGATCGTTCTTGCC	Fibroblasts
GCGTTTCTCTAAGGAA	Fibroblasts
GCTACAAAGATACGAT	Fibroblasts
GCTCAAATCGCACGAC	Fibroblasts
GCTGCAGCAGCGACCT	Fibroblasts
GCTTCACTCCTGGGAC	Mesothelial.cells
GCTTTCGAGCAATTAG	Myeloid.cells
GCTTTCGTCCCGAATA	Mesothelial.cells
GGAATCTGTCCGGATC	T.NK.cells
GGACGTCAGAACTCCT	Mesothelial.cells
GGAGGATGTTCATCTT	Mesothelial.cells
GGATGTTAGCGACTTT	Mesothelial.cells
GGGAAGTTCGGAGTAG	Mesothelial.cells
GGGACCTAGGAGCTGT	Fibroblasts
GGGACTCAGGAATCGC	Fibroblasts
GGGAGATAGACGGATC	Mesothelial.cells
GGGAGATCAGCATACT	Mesothelial.cells
GGGATCCAGAAGGATG	Mesothelial.cells
GGGCCATCAAACGTGG	Mesothelial.cells
GGGCGTTAGTTGTACC	Fibroblasts
GGGCTACGTTCGGCCA	T.NK.cells
GGGTAGATCGGTTCAA	Mesothelial.cells
GGGTCACAGGATGGCT	Mesothelial.cells
GGGTCACAGGGCCTCT	Mesothelial.cells
GGGTCACTCACGAGGA	Mesothelial.cells
GGTAACTCAATCGTCA	Mesothelial.cells
GGTAACTGTCAGGCAA	Mesothelial.cells
GGTAGAGCATGTGCTA	Mesothelial.cells
GGTCACGAGAAACTGT	T.NK.cells
GGTCTGGCACTCCTTG	Mesothelial.cells
GGTGTTAGTGTTTGCA	Mesothelial.cells
GGTTAACGTAAGTTGA	T.NK.cells
GGTTGTAGTCTCGACG	Mesothelial.cells
GTAAGTCTCTGTGCAA	Mesothelial.cells
GTAATGCGTCTCGGGT	Mesothelial.cells
GTAGAAATCAACTGAC	Mesothelial.cells
GTAGAGGAGTAAACTG	Mesothelial.cells
GTAGATCAGACGAGCT	Mesothelial.cells
GTAGGAGCACTGAGGA	Mesothelial.cells
GTATTGGCACTGTTCC	T.NK.cells
GTATTTCTCTTCTCAA	Mesothelial.cells
GTCACTCTCGGTCTAA	Myeloid.cells
GTCATCCCACGAAGAC	Mesothelial.cells
GTCATTTTCACGGGCT	Mesothelial.cells
GTCCCATTCGTACCTC	Fibroblasts
GTCGAATAGAGCCCAA	Myeloid.cells
GTCGTAAAGTAGTGCG	Mesothelial.cells
GTCTAGAAGCAAGTGC	Mesothelial.cells
GTCTGTCGTCACGCTG	Mesothelial.cells
GTCTTTAGTTATGTCG	T.NK.cells
GTCTTTATCTCGCCTA	T.NK.cells
GTGACGCCACATGAAA	Myeloid.cells
GTGAGGACAACCGTGC	Mesothelial.cells
GTGAGTTCAGGTCCGT	Mesothelial.cells
GTGATGTCACAGTACT	T.NK.cells
GTGATGTGTGCTTATG	Fibroblasts
GTGCACGGTAATGCGG	Mesothelial.cells
GTGCACGTCGACACCG	T.NK.cells
GTGCAGCAGGTAGACC	Fibroblasts
GTGCTGGGTTCAAAGA	Mesothelial.cells
GTGGAAGCATAACTCG	Mesothelial.cells
GTGGCGTTCGCCACTT	Mesothelial.cells
GTGGTTATCTATTGTC	Mesothelial.cells
GTGTAACCAGAGACTG	Fibroblasts
GTGTCCTCACCAGACC	Mesothelial.cells
GTGTCCTGTGTGGACA	Mesothelial.cells
GTGTTAGAGCAGTCTT	Mesothelial.cells
GTTACAGCAAGCGCAA	T.NK.cells
GTTACCCGTATTCTCT	T.NK.cells
GTTACCCTCGAACACT	Mesothelial.cells
GTTACGATCCTCTAGC	Mesothelial.cells
GTTAGTGCACCAAAGG	T.NK.cells
GTTATGGAGCGCTTCG	Mesothelial.cells
GTTCATTAGATGTTCC	Mesothelial.cells
GTTGCGGGTAAGACCG	Mesothelial.cells
GTTGCTCGTGGTGATG	Mesothelial.cells
GTTTGGAGTCTGTGCG	Mesothelial.cells
GTTTGGATCTCCGAAA	Mesothelial.cells
GTTTGGATCTCGCTCA	T.NK.cells
TAACTTCCACCAGTAT	Mesothelial.cells
TAACTTCGTACGTGTT	Mesothelial.cells
TAATCTCTCTCCGTGT	Mesothelial.cells
TAATTCCGTATGTCCA	T.NK.cells
TAATTCCTCACTCTTA	Mesothelial.cells
TACAGGTCACGGTGCT	T.NK.cells
TACAGGTGTTAAGAAC	T.NK.cells
TACAGGTTCCTCGCAT	Fibroblasts
TACCCACGTATCGTTG	T.NK.cells
TACCCACTCCCACAGG	Fibroblasts
TACCCACTCTCTAGGA	Fibroblasts
TACCCACTCTTGATTC	Mesothelial.cells
TACCGAAAGTCCGTCG	Mesothelial.cells
TACCGAAGTCATATGC	Mesothelial.cells
TACCGAATCTGTCAGA	T.NK.cells
TACCGGGCACGACTAT	T.NK.cells
TACCTCGCAAGTTCGT	T.NK.cells
TACGCTCGTCATGCAT	Mesothelial.cells
TACGGGCCAAGCAGGT	T.NK.cells
TACTGCCCAGCAGGAT	Fibroblasts
TACTTACTCGTCACCT	T.NK.cells
TAGACTGTCTATCGCC	Myeloid.cells
TAGCACACAAGATGTA	Mesothelial.cells
TAGCACATCCTGGGTG	T.NK.cells
TAGGAGGGTACTCGAT	Mesothelial.cells
TAGGAGGGTTTGTGGT	T.NK.cells
TAGGGTTGTAAGATTG	Mesothelial.cells
TATACCTAGCCATTCA	T.NK.cells
TATCTTGTCGCTTGAA	Mesothelial.cells
TATGTTCAGAAGAGCA	Mesothelial.cells
TATGTTCCAAGTTGGG	Mesothelial.cells
TATTCCAGTCTCCCTA	Mesothelial.cells
TATTGCTCACCGTCTT	Mesothelial.cells
TATTGCTGTTGTATGC	Mesothelial.cells
TATTGCTTCACTTCTA	Mesothelial.cells
TATTGGGGTTGCTCGG	Mesothelial.cells
TCAAGACTCAAAGGTA	T.NK.cells
TCAAGTGGTCTCAAGT	Mesothelial.cells
TCACGGGTCGTTAGTG	T.NK.cells
TCACTATAGGATTCCT	Myeloid.cells
TCACTCGCACGGCGTT	Fibroblasts
TCACTCGCAGCTCTGG	Mesothelial.cells
TCAGTTTGTTCTCTAT	Mesothelial.cells
TCATATCGTGTTGCCG	Mesothelial.cells
TCATATCTCACCATGA	Mesothelial.cells
TCATCCGGTTATAGAG	Mesothelial.cells
TCATTCAAGGATACAT	Mesothelial.cells
TCATTCACATATCTCT	Mesothelial.cells
TCCAGAATCCCTCATG	Fibroblasts
TCCATCGGTAGCGAGT	Mesothelial.cells
TCCATCGTCCACTGGG	Mesothelial.cells
TCCATGCAGCGAAACC	Fibroblasts
TCCCAGTGTTAAACAG	Mesothelial.cells
TCCGAAAAGACCATGG	Mesothelial.cells
TCCGATCAGAAACTAC	Mesothelial.cells
TCCGATCGTGCTATTG	T.NK.cells
TCCGTGTGTCGCACGT	Mesothelial.cells
TCCGTGTTCTGAGGTT	Mesothelial.cells
TCCTAATTCGATTTCT	T.NK.cells
TCCTCCCAGTTAGTGA	Fibroblasts
TCCTCGAGTCAGATTC	Mesothelial.cells
TCCTCTTTCCAGTGTA	Mesothelial.cells
TCCTGCACATTGAAGA	Fibroblasts
TCCTGCAGTTAGGCTT	Mesothelial.cells
TCGACGGGTAACATGA	Mesothelial.cells
TCGACGGGTTGGCTAT	Mesothelial.cells
TCGACGGTCCGCACTT	Mesothelial.cells
TCGACGGTCTGAGAGG	T.NK.cells
TCGATTTGTTCTCGTC	Mesothelial.cells
TCGCTTGAGTGCCAGA	Fibroblasts
TCGCTTGCAAAGGCAC	Fibroblasts
TCGCTTGGTACCGCGT	Mesothelial.cells
TCGGGCATCTGCCTGT	Fibroblasts
TCGGGTGCAGATAAAC	T.NK.cells
TCGGGTGTCCTGTTAT	Mesothelial.cells
TCGTAGACAGCGTGCT	Fibroblasts
TCGTGCTTCTCTCAAT	Mesothelial.cells
TCTACATAGTGTCATC	Mesothelial.cells
TCTATCAAGCCATTGT	Fibroblasts
TCTCACGAGGGCCCTT	Myeloid.cells
TCTCAGCTCACGAACT	Mesothelial.cells
TCTCCGAGTACACGCC	Mesothelial.cells
TCTCTGGTCTCGACCT	Mesothelial.cells
TCTGCCACAACTGCTA	Mesothelial.cells
TCTGGCTAGCGTACAG	Myeloid.cells
TCTGTCGCAAGAGAGA	Mesothelial.cells
TCTTAGTCAGATTTCG	Mesothelial.cells
TCTTAGTTCCTTCGAC	Mesothelial.cells
TCTTCCTTCAGAGTGG	Mesothelial.cells
TCTTTGAAGCAGCAGT	T.NK.cells
TGACAGTAGTGATAGT	Fibroblasts
TGAGACTAGCTTAAGA	Mesothelial.cells
TGAGCATTCATGGCCG	Mesothelial.cells
TGAGCATTCCGATCGG	T.NK.cells
TGAGCGCTCGAAGCAG	T.NK.cells
TGATCAGAGAGTCTGG	Mesothelial.cells
TGATCTTTCACCATGA	Mesothelial.cells
TGATTCTGTACCAATC	Mesothelial.cells
TGATTTCAGGGCAACT	Mesothelial.cells
TGCACGGCACGCAAAG	Fibroblasts
TGCAGATCATGAAGGC	T.NK.cells
TGCAGGCGTCCTATAG	T.NK.cells
TGCAGGCTCAGTGTTG	T.NK.cells
TGCGGCACACTGGAAG	Mesothelial.cells
TGCGGCATCTGGGCAC	Fibroblasts
TGCTCGTTCCAACTGA	Fibroblasts
TGCTGAATCTATCGGA	Mesothelial.cells
TGCTTCGGTCACTACA	Mesothelial.cells
TGCTTCGGTCCTGAAT	T.NK.cells
TGCTTCGGTTGGTAGG	Mesothelial.cells
TGCTTGCCACTCAAGT	T.NK.cells
TGGAACTCATTCTTCA	Fibroblasts
TGGAGAGAGGGTGAGG	Mesothelial.cells
TGGATCAAGACGCAGT	Mesothelial.cells
TGGCGTGGTGATGTAA	Mesothelial.cells
TGGGAAGCAGAGAGGG	Mesothelial.cells
TGGGATTAGGACGCTA	Mesothelial.cells
TGGGCTGAGATACGAT	Mesothelial.cells
TGGGCTGTCCTACAAG	Fibroblasts
TGGGTTAAGTTTGCTG	T.NK.cells
TGGTACAAGTCTCTGA	T.NK.cells
TGGTAGTGTCGTTTCC	T.NK.cells
TGGTTAGAGTGCACTT	T.NK.cells
TGTAACGGTTAGGGAC	T.NK.cells
TGTAAGCCAAACTCGT	Mesothelial.cells
TGTAAGCCAACCGCTG	Mesothelial.cells
TGTAGACAGCGGGTAT	T.NK.cells
TGTCAGATCATCTATC	Fibroblasts
TGTCCACGTATCGGTT	Mesothelial.cells
TGTCCTGTCCGCACGA	T.NK.cells
TGTGCGGGTTTACTTC	T.NK.cells
TGTGCGGTCCATGCAA	Mesothelial.cells
TGTGGCGGTGGCAGAT	T.NK.cells
TGTTACTAGGCTCCCA	Mesothelial.cells
TGTTACTAGTTGCGCC	Mesothelial.cells
TGTTCATAGGACAAGA	Mesothelial.cells
TGTTCTACAAATAAGC	T.NK.cells
TGTTTGTAGCTAATCC	Mesothelial.cells
TTACCATCATATTCGG	Mesothelial.cells
TTACCGCCAGTTCTAG	Mesothelial.cells
TTACCGCGTGGTCCCA	Mesothelial.cells
TTACGTTAGCTGTTCA	T.NK.cells
TTAGGCACACATAGCT	Mesothelial.cells
TTAGTCTAGTGGATAT	T.NK.cells
TTAGTCTTCCACGTAA	Mesothelial.cells
TTAGTCTTCCGAAATC	T.NK.cells
TTATTGCCAGATACTC	Mesothelial.cells
TTCACGCCACTGAGGA	Mesothelial.cells
TTCAGGACACCTGCGA	T.NK.cells
TTCATGTGTAACTGCT	Mesothelial.cells
TTCATTGTCCAACCGG	Mesothelial.cells
TTCCGTGAGCAACAGC	Fibroblasts
TTCCTAACAACTCATG	T.NK.cells
TTCCTAATCTTGGTCC	Mesothelial.cells
TTCGATTCAGCAGTTT	Mesothelial.cells
TTCGCTGGTTCTGACA	Mesothelial.cells
TTCTAACCACCTTCCA	Fibroblasts
TTCTAACTCTCGTCAC	T.NK.cells
TTCTCTCCACGAGGTA	T.NK.cells
TTCTGTAAGGCTTAAA	Fibroblasts
TTGAGTGCACTAACCA	Fibroblasts
TTGCATTAGGCTAACG	T.NK.cells
TTGCTGCGTTGGGATG	Fibroblasts
TTGTGGACAGGGTTGA	Mesothelial.cells
TTGTTCAAGGGATCAC	Mesothelial.cells
TTGTTCACAACCCGCA	Mesothelial.cells
TTGTTCAGTCATGCAT	Mesothelial.cells
TTGTTCATCATTCGTT	Fibroblasts
TTTACCAAGCGCCTAC	Mesothelial.cells
TTTACGTCACAGCGCT	Mesothelial.cells
TTTATGCCAAGCTCTA	Fibroblasts
TTTATGCCATCTAACG	T.NK.cells
TTTCACATCTCAAAGC	Fibroblasts
TTTCAGTCAATACGAA	T.NK.cells
TTTCAGTGTTCATCTT	Mesothelial.cells
TTTCATGCAGCTGTCG	Mesothelial.cells
TTTCGATGTAACCCGC	Mesothelial.cells
